,type,start,end,strand,length,name,AT_composition,cell wall
1,gene,409,1750,1,1341,dnaA,59.8806860551827,
2,CDS,409,1750,1,1341,dnaA,59.8806860551827,
3,gene,1938,3075,1,1137,dnaN,60.070360598065086,
4,CDS,1938,3075,1,1137,dnaN,60.070360598065086,
5,gene,3205,3421,1,216,rlbA,56.481481481481474,
6,CDS,3205,3421,1,216,rlbA,56.481481481481474,
7,gene,3436,4549,1,1113,recF,54.44743935309974,
8,CDS,3436,4549,1,1113,recF,54.44743935309974,
10,CDS,4566,4812,1,246,remB,63.00813008130082,
9,gene,4566,4812,1,246,remB,63.00813008130082,
11,gene,4866,6783,1,1917,gyrB,54.98174230568596,
12,CDS,4866,6783,1,1917,gyrB,54.98174230568596,
13,gene,6993,9459,1,2466,gyrA,55.59610705596108,
14,CDS,6993,9459,1,2466,gyrA,55.59610705596108,
16,rRNA,9809,11364,1,1555,rrnO-16S,44.951768488745984,
15,gene,9809,11364,1,1555,rrnO-16S,44.951768488745984,
18,tRNA,11463,11540,1,77,trnO-Ile,37.66233766233766,
17,gene,11463,11540,1,77,trnO-Ile,37.66233766233766,
19,gene,11551,11627,1,76,trnO-Ala,34.21052631578947,
20,tRNA,11551,11627,1,76,trnO-Ala,34.21052631578947,
21,gene,11708,14636,1,2928,rrnO-23S,46.10655737704918,
22,rRNA,11708,14636,1,2928,rrnO-23S,46.10655737704918,
24,rRNA,14691,14810,1,119,rrnO-5S,42.016806722689076,
23,gene,14691,14810,1,119,rrnO-5S,42.016806722689076,
25,gene,14846,15794,-1,948,yaaC,65.40084388185655,
26,CDS,14846,15794,-1,948,yaaC,65.40084388185655,
27,gene,15914,17381,1,1467,guaB,56.50988411724608,
28,CDS,15914,17381,1,1467,guaB,56.50988411724608,
29,gene,17533,18865,1,1332,dacA,59.45945945945946,
30,CDS,17533,18865,1,1332,dacA,59.45945945945946,
31,gene,19061,19946,1,885,pdxS,54.01129943502825,
32,CDS,19061,19946,1,885,pdxS,54.01129943502825,
34,CDS,19967,20558,1,591,pdxT,53.63790186125211,
33,gene,19967,20558,1,591,pdxT,53.63790186125211,
36,misc_RNA,20610,20823,1,213,tboS,53.52112676056338,
35,gene,20610,20823,1,213,tboS,53.52112676056338,
37,gene,20879,22157,1,1278,serS,55.55555555555556,
38,CDS,20879,22157,1,1278,serS,55.55555555555556,
39,gene,22291,22384,1,93,trnSL-Ser1,39.784946236559136,
40,tRNA,22291,22384,1,93,trnSL-Ser1,39.784946236559136,
42,CDS,22495,23149,-1,654,dck,62.38532110091744,
41,gene,22495,23149,-1,654,dck,62.38532110091744,
44,CDS,23145,23769,-1,624,dgk,59.455128205128204,
43,gene,23145,23769,-1,624,dgk,59.455128205128204,
45,gene,23867,25151,-1,1284,sleL,54.04984423676012,
46,CDS,23867,25151,-1,1284,sleL,54.04984423676012,
47,gene,25220,25766,-1,546,yaaI,62.27106227106227,
48,CDS,25220,25766,-1,546,yaaI,62.27106227106227,
49,gene,25851,26337,1,486,tadA,54.52674897119342,
50,CDS,25851,26337,1,486,tadA,54.52674897119342,
52,misc_RNA,26378,26732,1,354,scr,52.54237288135594,
51,gene,26378,26732,1,354,scr,52.54237288135594,
54,CDS,26813,28505,1,1692,dnaX,56.442080378250594,
53,gene,26813,28505,1,1692,dnaX,56.442080378250594,
55,gene,28528,28852,1,324,ebfC,60.49382716049383,
56,CDS,28528,28852,1,324,ebfC,60.49382716049383,
57,gene,28866,29463,1,597,recR,56.78391959798995,
58,CDS,28866,29463,1,597,recR,56.78391959798995,
59,gene,29480,29705,1,225,yaaL,62.22222222222222,
60,CDS,29480,29705,1,225,yaaL,62.22222222222222,
61,gene,29771,30035,1,264,bofA,60.984848484848484,
62,CDS,29771,30035,1,264,bofA,60.984848484848484,
63,gene,30278,31832,1,1554,rrnA-16S,44.98069498069498,
64,rRNA,30278,31832,1,1554,rrnA-16S,44.98069498069498,
65,gene,31931,32008,1,77,trnA-Ile,37.66233766233766,
66,tRNA,31931,32008,1,77,trnA-Ile,37.66233766233766,
68,tRNA,32019,32095,1,76,trnA-Ala,34.21052631578947,
67,gene,32019,32095,1,76,trnA-Ala,34.21052631578947,
69,gene,32176,35103,1,2927,rrnA-23S,46.12230953194397,
70,rRNA,32176,35103,1,2927,rrnA-23S,46.12230953194397,
72,rRNA,35236,35355,1,119,rrnA-5S,42.016806722689076,
71,gene,35236,35355,1,119,rrnA-5S,42.016806722689076,
73,gene,35530,35725,1,195,csfB,67.6923076923077,
74,CDS,35530,35725,1,195,csfB,67.6923076923077,
75,gene,35844,36459,1,615,xpaC,63.08943089430894,
76,CDS,35844,36459,1,615,xpaC,63.08943089430894,
77,gene,36477,37638,1,1161,yaaN,59.68992248062015,
78,CDS,36477,37638,1,1161,yaaN,59.68992248062015,
79,gene,37719,39162,1,1443,yaaO,57.03395703395704,
80,CDS,37719,39162,1,1443,yaaO,57.03395703395704,
81,gene,39158,39797,1,639,tmk,58.84194053208138,
82,CDS,39158,39797,1,639,tmk,58.84194053208138,
83,gene,39870,40200,1,330,darA,58.18181818181818,
84,CDS,39870,40200,1,330,darA,58.18181818181818,
86,CDS,40212,40653,1,441,yaaR,63.038548752834465,
85,gene,40212,40653,1,441,yaaR,63.038548752834465,
87,gene,40664,41654,1,990,holB,58.282828282828284,
88,CDS,40664,41654,1,990,holB,58.282828282828284,
90,CDS,41656,42484,1,828,ricT,57.125603864734295,
89,gene,41656,42484,1,828,ricT,57.125603864734295,
91,gene,42498,42858,1,360,dnaH,62.22222222222222,
92,CDS,42498,42858,1,360,dnaH,62.22222222222222,
94,CDS,42916,43660,1,744,trmNF,57.66129032258065,
93,gene,42916,43660,1,744,trmNF,57.66129032258065,
95,gene,43646,43946,1,300,yazA,59.66666666666667,
96,CDS,43646,43946,1,300,yazA,59.66666666666667,
98,CDS,43920,44799,1,879,rsmI,56.76905574516496,
97,gene,43920,44799,1,879,rsmI,56.76905574516496,
99,gene,44847,45138,-1,291,abrB,64.60481099656357,
100,CDS,44847,45138,-1,291,abrB,64.60481099656357,
101,gene,45632,47627,1,1995,metS,57.89473684210527,
102,CDS,45632,47627,1,1995,metS,57.89473684210527,
104,CDS,47705,48473,1,768,dayD,57.682291666666664,
103,gene,47705,48473,1,768,dayD,57.682291666666664,
106,CDS,48628,49942,1,1314,yabE,58.44748858447488,putative cell wall shaping enzyme
105,gene,48628,49942,1,1314,yabE,58.44748858447488,
108,CDS,50086,50647,1,561,rnmV,53.83244206773619,
107,gene,50086,50647,1,561,rnmV,53.83244206773619,
109,gene,50639,51518,1,879,rsmA,56.5415244596132,
110,CDS,50639,51518,1,879,rsmA,56.5415244596132,
112,CDS,51679,52552,1,873,prtG,57.73195876288659,
111,gene,51679,52552,1,873,prtG,57.73195876288659,
113,gene,52762,53023,1,261,veg,57.8544061302682,
114,CDS,52762,53023,1,261,veg,57.8544061302682,
115,gene,53182,53368,1,186,sspF,54.3010752688172,
116,CDS,53182,53368,1,186,sspF,54.3010752688172,
118,CDS,53515,54385,1,870,ispE,51.95402298850574,
117,gene,53515,54385,1,870,ispE,51.95402298850574,
119,gene,54440,55298,1,858,purR,57.34265734265735,
120,CDS,54440,55298,1,858,purR,57.34265734265735,
122,CDS,55294,55672,1,378,ridA,55.82010582010582,
121,gene,55294,55672,1,378,ridA,55.82010582010582,
123,gene,55865,56159,1,294,spoVG,55.10204081632652,
124,CDS,55865,56159,1,294,spoVG,55.10204081632652,
126,CDS,56351,57722,1,1371,glmU,56.819839533187455,
125,gene,56351,57722,1,1371,glmU,56.819839533187455,
127,gene,57744,58698,1,954,prs,57.33752620545073,
128,CDS,57744,58698,1,954,prs,57.33752620545073,
129,gene,58782,59397,1,615,ctc,53.82113821138211,
130,CDS,58782,59397,1,615,ctc,53.82113821138211,
131,gene,59503,60070,1,567,pth,56.4373897707231,
132,CDS,59503,60070,1,567,pth,56.4373897707231,
133,gene,60129,60360,1,231,fin,61.471861471861466,
134,CDS,60129,60360,1,231,fin,61.471861471861466,
135,gene,60429,63963,1,3534,mfd,54.83870967741935,
136,CDS,60429,63963,1,3534,mfd,54.83870967741935,
137,gene,64098,64635,1,537,spoVT,54.93482309124767,
138,CDS,64098,64635,1,537,spoVT,54.93482309124767,
140,CDS,64816,66415,1,1599,yabM,55.53470919324578,
139,gene,64816,66415,1,1599,yabM,55.53470919324578,
142,CDS,66404,67874,1,1470,yabN,55.17006802721088,
141,gene,66404,67874,1,1470,yabN,55.17006802721088,
143,gene,67876,68137,1,261,hslR,58.620689655172406,
144,CDS,67876,68137,1,261,hslR,58.620689655172406,
145,gene,68215,68518,1,303,spcP,60.726072607260726,
146,CDS,68215,68518,1,303,spcP,60.726072607260726,
147,gene,68514,69150,1,636,spcQ,61.0062893081761,
148,CDS,68514,69150,1,636,spcQ,61.0062893081761,
149,gene,69167,69545,1,378,divIC,60.05291005291006,
150,CDS,69167,69545,1,378,divIC,60.05291005291006,
151,gene,69625,70012,1,387,yabR,60.20671834625323,
152,CDS,69625,70012,1,387,yabR,60.20671834625323,
153,gene,70180,70257,1,77,trnSL-Met1,35.064935064935064,
154,tRNA,70180,70257,1,77,trnSL-Met1,35.064935064935064,
156,tRNA,70266,70338,1,72,trnSL-Glu1,38.88888888888889,
155,gene,70266,70338,1,72,trnSL-Glu1,38.88888888888889,
158,CDS,70537,73021,1,2484,spoIIE,56.23993558776168,
157,gene,70537,73021,1,2484,spoIIE,56.23993558776168,
159,gene,73105,73843,1,738,yabS,53.794037940379404,
160,CDS,73105,73843,1,738,yabS,53.794037940379404,
161,gene,73808,74825,1,1017,prkT,56.14552605703048,
162,CDS,73808,74825,1,1017,prkT,56.14552605703048,
164,CDS,74928,76347,1,1419,tilS,55.95489781536293,
163,gene,74928,76347,1,1419,tilS,55.95489781536293,
166,CDS,76343,76886,1,543,hprT,60.773480662983424,
165,gene,76343,76886,1,543,hprT,60.773480662983424,
167,gene,76983,78897,1,1914,ftsH,54.02298850574713,
168,CDS,76983,78897,1,1914,ftsH,54.02298850574713,
169,gene,79091,79868,1,777,coaX,57.14285714285714,
170,CDS,79091,79868,1,777,coaX,57.14285714285714,
171,gene,79879,80755,1,876,hslO,55.593607305936075,
172,CDS,79879,80755,1,876,hslO,55.593607305936075,
174,CDS,80801,81695,1,894,yacD,59.619686800894854,
173,gene,80801,81695,1,894,yacD,59.619686800894854,
176,CDS,81770,82697,1,927,cysK,54.476806903991374,
175,gene,81770,82697,1,927,cysK,54.476806903991374,
177,gene,82863,84276,1,1413,pabB,57.254069355980185,
178,CDS,82863,84276,1,1413,pabB,57.254069355980185,
179,gene,84289,84874,1,585,pabA,54.700854700854705,
180,CDS,84289,84874,1,585,pabA,54.700854700854705,
182,CDS,84873,85755,1,882,pabC,56.12244897959183,
181,gene,84873,85755,1,882,pabC,56.12244897959183,
184,CDS,85736,86594,1,858,folP,52.44755244755245,
183,gene,85736,86594,1,858,folP,52.44755244755245,
185,gene,86586,86949,1,363,folB,56.473829201101935,
186,CDS,86586,86949,1,363,folB,56.473829201101935,
187,gene,86945,87449,1,504,folK,56.94444444444444,
188,CDS,86945,87449,1,504,folK,56.94444444444444,
189,gene,87400,87610,1,210,yazB,57.14285714285714,
190,CDS,87400,87610,1,210,yazB,57.14285714285714,
192,CDS,87633,88635,1,1002,dusB,55.18962075848304,
191,gene,87633,88635,1,1002,dusB,55.18962075848304,
194,CDS,88726,90226,1,1500,lysS,56.666666666666664,
193,gene,88726,90226,1,1500,lysS,56.666666666666664,
195,gene,90535,92089,1,1554,rrnJ-16S,44.98069498069498,
196,rRNA,90535,92089,1,1554,rrnJ-16S,44.98069498069498,
197,gene,92253,95181,1,2928,rrnJ-23S,46.10655737704918,
198,rRNA,92253,95181,1,2928,rrnJ-23S,46.10655737704918,
199,gene,95236,95354,1,118,rrnJ-5S,42.3728813559322,
200,rRNA,95236,95354,1,118,rrnJ-5S,42.3728813559322,
201,gene,95374,95450,1,76,trnJ-Val,39.473684210526315,
202,tRNA,95374,95450,1,76,trnJ-Val,39.473684210526315,
203,gene,95454,95530,1,76,trnJ-Thr,47.368421052631575,
204,tRNA,95454,95530,1,76,trnJ-Thr,47.368421052631575,
205,gene,95566,95642,1,76,trnJ-Lys,51.31578947368421,
206,tRNA,95566,95642,1,76,trnJ-Lys,51.31578947368421,
208,tRNA,95648,95731,1,83,trnJ-Leu1,43.373493975903614,
207,gene,95648,95731,1,83,trnJ-Leu1,43.373493975903614,
210,tRNA,95771,95846,1,75,trnJ-Gly,40.0,
209,gene,95771,95846,1,75,trnJ-Gly,40.0,
212,tRNA,95860,95946,1,86,trnJ-Leu2,39.53488372093023,
211,gene,95860,95946,1,86,trnJ-Leu2,39.53488372093023,
213,gene,95955,96032,1,77,trnJ-Arg,42.857142857142854,
214,tRNA,95955,96032,1,77,trnJ-Arg,42.857142857142854,
215,gene,96059,96136,1,77,trnJ-Pro,42.857142857142854,
216,tRNA,96059,96136,1,77,trnJ-Pro,42.857142857142854,
217,gene,96145,96221,1,76,trnJ-Ala,34.21052631578947,
218,tRNA,96145,96221,1,76,trnJ-Ala,34.21052631578947,
220,rRNA,96391,97945,1,1554,rrnW-16S,45.04504504504504,
219,gene,96391,97945,1,1554,rrnW-16S,45.04504504504504,
221,gene,98109,101037,1,2928,rrnW-23S,46.10655737704918,
222,rRNA,98109,101037,1,2928,rrnW-23S,46.10655737704918,
223,gene,101092,101211,1,119,rrnW-5S,42.016806722689076,
224,rRNA,101092,101211,1,119,rrnW-5S,42.016806722689076,
226,CDS,101448,101913,1,465,ctsR,66.02150537634408,
225,gene,101448,101913,1,465,ctsR,66.02150537634408,
228,CDS,101926,102484,1,558,mcsA,62.903225806451616,
227,gene,101926,102484,1,558,mcsA,62.903225806451616,
230,CDS,102483,103575,1,1092,mcsB,58.15018315018315,
229,gene,102483,103575,1,1092,mcsB,58.15018315018315,
231,gene,103571,106004,1,2433,clpC,56.473489519112206,
232,CDS,103571,106004,1,2433,clpC,56.473489519112206,
234,CDS,106095,107472,1,1377,radA,54.974582425562815,
233,gene,106095,107472,1,1377,radA,54.974582425562815,
235,gene,107475,108558,1,1083,disA,59.64912280701754,
236,CDS,107475,108558,1,1083,disA,59.64912280701754,
237,gene,108673,109774,1,1101,yacL,59.763851044505,
238,CDS,108673,109774,1,1101,yacL,59.763851044505,
240,CDS,109788,110487,1,699,ispD,52.07439198855508,
239,gene,109788,110487,1,699,ispD,52.07439198855508,
241,gene,110479,110956,1,477,ispF,53.459119496855344,
242,CDS,110479,110956,1,477,ispF,53.459119496855344,
244,CDS,111046,112498,1,1452,gltX,56.81818181818182,
243,gene,111046,112498,1,1452,gltX,56.81818181818182,
245,gene,112799,113453,1,654,cysE,56.42201834862385,
246,CDS,112799,113453,1,654,cysE,56.42201834862385,
248,CDS,113449,114850,1,1401,cysS,56.53104925053534,
247,gene,113449,114850,1,1401,cysS,56.53104925053534,
249,gene,114853,115285,1,432,mrnC,57.870370370370374,
250,CDS,114853,115285,1,432,mrnC,57.870370370370374,
252,CDS,115268,116018,1,750,rlmB,52.53333333333333,
251,gene,115268,116018,1,750,rlmB,52.53333333333333,
253,gene,116024,116537,1,513,raeA,55.55555555555556,
254,CDS,116024,116537,1,513,raeA,55.55555555555556,
255,gene,116599,117256,1,657,sigH,59.51293759512938,
256,CDS,116599,117256,1,657,sigH,59.51293759512938,
257,gene,117348,117498,1,150,rpmGB,61.33333333333333,
258,CDS,117348,117498,1,150,rpmGB,61.33333333333333,
259,gene,117531,117711,1,180,secE,68.88888888888889,
260,CDS,117531,117711,1,180,secE,68.88888888888889,
262,CDS,117889,118423,1,534,nusG,58.80149812734082,
261,gene,117889,118423,1,534,nusG,58.80149812734082,
264,CDS,118590,119016,1,426,rplK,56.57276995305164,
263,gene,118590,119016,1,426,rplK,56.57276995305164,
265,gene,119110,119809,1,699,rplA,58.22603719599427,
266,CDS,119110,119809,1,699,rplA,58.22603719599427,
267,gene,119854,119995,1,141,ldlJ,61.702127659574465,
268,misc_RNA,119854,119995,1,141,ldlJ,61.702127659574465,
269,gene,120060,120561,1,501,rplJ,58.08383233532935,
270,CDS,120060,120561,1,501,rplJ,58.08383233532935,
272,CDS,120606,120978,1,372,rplL,58.602150537634415,
271,gene,120606,120978,1,372,rplL,58.602150537634415,
273,gene,121067,121673,1,606,rlmG,58.745874587458744,
274,CDS,121067,121673,1,606,rlmG,58.745874587458744,
275,gene,121918,125500,1,3582,rpoB,54.69011725293132,
276,CDS,121918,125500,1,3582,rpoB,54.69011725293132,
277,gene,125561,129161,1,3600,rpoC,55.13888888888889,
278,CDS,125561,129161,1,3600,rpoC,55.13888888888889,
279,gene,129339,129588,1,249,rulS,58.63453815261044,
280,CDS,129339,129588,1,249,rulS,58.63453815261044,
282,CDS,129701,130118,1,417,rpsL,56.11510791366906,
281,gene,129701,130118,1,417,rpsL,56.11510791366906,
284,CDS,130159,130630,1,471,rpsG,57.961783439490446,
283,gene,130159,130630,1,471,rpsG,57.961783439490446,
285,gene,130683,132762,1,2079,fusA,56.421356421356414,
286,CDS,130683,132762,1,2079,fusA,56.421356421356414,
287,gene,132881,134072,1,1191,tufA,56.08732157850545,
288,CDS,132881,134072,1,1191,tufA,56.08732157850545,
289,gene,134170,135127,1,957,ybaC,59.979101358411704,
290,CDS,134170,135127,1,957,ybaC,59.979101358411704,
291,gene,135363,135672,1,309,rpsJ,61.165048543689316,
292,CDS,135363,135672,1,309,rpsJ,61.165048543689316,
293,gene,135711,136341,1,630,rplC,57.3015873015873,
294,CDS,135711,136341,1,630,rplC,57.3015873015873,
295,gene,136368,136992,1,624,rplD,57.692307692307686,
296,CDS,136368,136992,1,624,rplD,57.692307692307686,
298,CDS,136991,137279,1,288,rplW,61.111111111111114,
297,gene,136991,137279,1,288,rplW,61.111111111111114,
300,CDS,137310,138144,1,834,rplB,56.11510791366906,
299,gene,137310,138144,1,834,rplB,56.11510791366906,
301,gene,138201,138480,1,279,rpsS,59.13978494623656,
302,CDS,138201,138480,1,279,rpsS,59.13978494623656,
303,gene,138496,138838,1,342,rplV,56.14035087719298,
304,CDS,138496,138838,1,342,rplV,56.14035087719298,
306,CDS,138841,139498,1,657,rpsC,55.8599695585997,
305,gene,138841,139498,1,657,rpsC,55.8599695585997,
308,CDS,139499,139934,1,435,rplP,56.55172413793104,
307,gene,139499,139934,1,435,rplP,56.55172413793104,
309,gene,139923,140124,1,201,rpmC,62.68656716417911,
310,CDS,139923,140124,1,201,rpmC,62.68656716417911,
311,gene,140146,140410,1,264,rpsQ,63.63636363636363,
312,CDS,140146,140410,1,264,rpsQ,63.63636363636363,
313,gene,140450,140819,1,369,rplNA,56.91056910569105,
314,CDS,140450,140819,1,369,rplNA,56.91056910569105,
316,CDS,140856,141168,1,312,rplX,60.256410256410255,
315,gene,140856,141168,1,312,rplX,60.256410256410255,
318,CDS,141194,141734,1,540,rplE,58.51851851851851,
317,gene,141194,141734,1,540,rplE,58.51851851851851,
319,gene,141756,141942,1,186,rpsNA,58.06451612903226,
320,CDS,141756,141942,1,186,rpsNA,58.06451612903226,
321,gene,141973,142372,1,399,rpsH,59.64912280701754,
322,CDS,141973,142372,1,399,rpsH,59.64912280701754,
324,CDS,142401,142941,1,540,rplF,57.22222222222222,
323,gene,142401,142941,1,540,rplF,57.22222222222222,
326,CDS,142973,143336,1,363,rplR,57.02479338842975,
325,gene,142973,143336,1,363,rplR,57.02479338842975,
327,gene,143360,143861,1,501,rpsE,55.688622754491014,
328,CDS,143360,143861,1,501,rpsE,55.688622754491014,
329,gene,143874,144054,1,180,rpmD,62.77777777777778,
330,CDS,143874,144054,1,180,rpmD,62.77777777777778,
331,gene,144084,144525,1,441,rplO,56.00907029478458,
332,CDS,144084,144525,1,441,rplO,56.00907029478458,
334,CDS,144526,145822,1,1296,secY,58.25617283950617,
333,gene,144526,145822,1,1296,secY,58.25617283950617,
336,CDS,145876,146530,1,654,adk,56.727828746177366,
335,gene,145876,146530,1,654,adk,56.727828746177366,
337,gene,146526,147273,1,747,mapA,55.68942436412316,
338,CDS,146526,147273,1,747,mapA,55.68942436412316,
339,gene,147311,147536,1,225,ybzG,61.33333333333333,
340,CDS,147311,147536,1,225,ybzG,61.33333333333333,
341,gene,147584,147803,1,219,infA,59.3607305936073,
342,CDS,147584,147803,1,219,infA,59.3607305936073,
343,gene,147836,147950,1,114,rpmJ,67.54385964912281,
344,CDS,147836,147950,1,114,rpmJ,67.54385964912281,
345,gene,147972,148338,1,366,rpsM,56.830601092896174,
346,CDS,147972,148338,1,366,rpsM,56.830601092896174,
347,gene,148358,148754,1,396,rpsK,54.292929292929294,
348,CDS,148358,148754,1,396,rpsK,54.292929292929294,
349,gene,148930,149875,1,945,rpoA,58.201058201058196,
350,CDS,148930,149875,1,945,rpoA,58.201058201058196,
352,CDS,149952,150315,1,363,rplQ,55.64738292011019,
351,gene,149952,150315,1,363,rplQ,55.64738292011019,
354,CDS,150442,151288,1,846,ecfA,55.319148936170215,
353,gene,150442,151288,1,846,ecfA,55.319148936170215,
355,gene,151302,152133,1,831,ecfAB,54.75330926594465,
356,CDS,151302,152133,1,831,ecfAB,54.75330926594465,
357,gene,152129,152927,1,798,ecfT,58.1453634085213,
358,CDS,152129,152927,1,798,ecfT,58.1453634085213,
360,CDS,152936,153680,1,744,truA,52.82258064516129,
359,gene,152936,153680,1,744,truA,52.82258064516129,
362,misc_RNA,153736,153793,1,57,ldlM,57.89473684210527,
361,gene,153736,153793,1,57,ldlM,57.89473684210527,
363,gene,153841,154279,1,438,rplM,58.21917808219178,
364,CDS,153841,154279,1,438,rplM,58.21917808219178,
365,gene,154299,154692,1,393,rpsI,54.4529262086514,
366,CDS,154299,154692,1,393,rpsI,54.4529262086514,
368,CDS,155155,155923,1,768,ybaJ,59.375,
367,gene,155155,155923,1,768,ybaJ,59.375,
369,gene,156108,156552,1,444,ybaK,61.261261261261254,
370,CDS,156108,156552,1,444,ybaK,61.261261261261254,
372,CDS,156611,157325,1,714,cwlD,56.30252100840336,
371,gene,156611,157325,1,714,cwlD,56.30252100840336,
373,gene,157420,158479,1,1059,salA,55.61850802644004,
374,CDS,157420,158479,1,1059,salA,55.61850802644004,
375,gene,158514,159072,-1,558,gerD,62.903225806451616,
376,CDS,158514,159072,-1,558,gerD,62.903225806451616,
377,gene,159181,159778,1,597,kbaA,61.13902847571189,
378,CDS,159181,159778,1,597,kbaA,61.13902847571189,
380,CDS,159778,160543,-1,765,pdaB,58.03921568627452,
379,gene,159778,160543,-1,765,pdaB,58.03921568627452,
382,rRNA,160892,162445,1,1553,rrnI-16S,45.267224726336124,
381,gene,160892,162445,1,1553,rrnI-16S,45.267224726336124,
383,gene,162609,165535,1,2926,rrnI-23S,46.103896103896105,
384,rRNA,162609,165535,1,2926,rrnI-23S,46.103896103896105,
385,gene,165590,165707,1,117,rrnI-5S,41.88034188034188,
386,rRNA,165590,165707,1,117,rrnI-5S,41.88034188034188,
388,tRNA,165753,165825,1,72,trnI-Asn,44.44444444444444,
387,gene,165753,165825,1,72,trnI-Asn,44.44444444444444,
390,tRNA,165829,165902,1,73,trnI-Thr,43.83561643835616,
389,gene,165829,165902,1,73,trnI-Thr,43.83561643835616,
391,gene,165958,166033,1,75,trnI-Gly,40.0,
392,tRNA,165958,166033,1,75,trnI-Gly,40.0,
393,gene,166063,166140,1,77,trnI-Arg,42.857142857142854,
394,tRNA,166063,166140,1,77,trnI-Arg,42.857142857142854,
395,gene,166167,166244,1,77,trnI-Pro,42.857142857142854,
396,tRNA,166167,166244,1,77,trnI-Pro,42.857142857142854,
397,gene,166252,166328,1,76,trnI-Ala,34.21052631578947,
398,tRNA,166252,166328,1,76,trnI-Ala,34.21052631578947,
399,gene,166499,168053,1,1554,rrnH-16S,44.98069498069498,
400,rRNA,166499,168053,1,1554,rrnH-16S,44.98069498069498,
401,gene,168217,171141,1,2924,rrnH-23S,46.16963064295486,
402,rRNA,168217,171141,1,2924,rrnH-23S,46.16963064295486,
404,rRNA,171196,171314,1,118,rrnH-5S,42.3728813559322,
403,gene,171196,171314,1,118,rrnH-5S,42.3728813559322,
406,rRNA,171497,173049,1,1552,rrnG-16S,45.2319587628866,
405,gene,171497,173049,1,1552,rrnG-16S,45.2319587628866,
407,gene,173213,176141,1,2928,rrnG-23S,46.14071038251366,
408,rRNA,173213,176141,1,2928,rrnG-23S,46.14071038251366,
409,gene,176196,176315,1,119,rrnG-5S,42.016806722689076,
410,rRNA,176196,176315,1,119,rrnG-5S,42.016806722689076,
412,CDS,177082,178519,1,1437,ybaR,57.06332637439109,
411,gene,177082,178519,1,1437,ybaR,57.06332637439109,
414,CDS,178664,179585,1,921,ybaS,55.37459283387622,
413,gene,178664,179585,1,921,ybaS,55.37459283387622,
415,gene,179594,180347,-1,753,eesA,53.51925630810093,
416,CDS,179594,180347,-1,753,eesA,53.51925630810093,
417,gene,180343,181354,-1,1011,feuC,52.818991097922854,
418,CDS,180343,181354,-1,1011,feuC,52.818991097922854,
419,gene,181346,182351,-1,1005,feuB,54.72636815920397,
420,CDS,181346,182351,-1,1005,feuB,54.72636815920397,
422,CDS,182369,183323,-1,954,feuA,59.11949685534591,
421,gene,182369,183323,-1,954,feuA,59.11949685534591,
423,gene,183413,185003,-1,1590,btr,57.42138364779874,
424,CDS,183413,185003,-1,1590,btr,57.42138364779874,
426,CDS,185193,186438,-1,1245,ybbC,56.06425702811245,
425,gene,185193,186438,-1,1245,ybbC,56.06425702811245,
427,gene,186451,188380,-1,1929,nagZ,54.691550025920165,
428,CDS,186451,188380,-1,1929,nagZ,54.691550025920165,
429,gene,188407,189733,-1,1326,amiE,55.12820512820513,
430,CDS,188407,189733,-1,1326,amiE,55.12820512820513,
431,gene,189789,191157,-1,1368,murP,52.63157894736842,
432,CDS,189789,191157,-1,1368,murP,52.63157894736842,
433,gene,191182,192034,-1,852,murR,52.46478873239436,
434,CDS,191182,192034,-1,852,murR,52.46478873239436,
435,gene,192050,192965,-1,915,murQ,52.240437158469945,
436,CDS,192050,192965,-1,915,murQ,52.240437158469945,
437,gene,193074,193557,-1,483,ybbJ,54.45134575569358,
438,CDS,193074,193557,-1,483,ybbJ,54.45134575569358,
439,gene,193569,194025,-1,456,ybbK,52.41228070175439,
440,CDS,193569,194025,-1,456,ybbK,52.41228070175439,
442,tRNA,194204,194279,1,75,trnSL-Glu2,38.666666666666664,
441,gene,194204,194279,1,75,trnSL-Glu2,38.666666666666664,
444,tRNA,194282,194358,1,76,trnSL-Val1,39.473684210526315,
443,gene,194282,194358,1,76,trnSL-Val1,39.473684210526315,
445,gene,194362,194435,1,73,trnSL-Thr1,47.94520547945205,
446,tRNA,194362,194435,1,73,trnSL-Thr1,47.94520547945205,
447,gene,194457,194542,1,85,trnSL-Tyr1,37.64705882352941,
448,tRNA,194457,194542,1,85,trnSL-Tyr1,37.64705882352941,
450,tRNA,194546,194621,1,75,trnSL-Gln2,45.33333333333333,
449,gene,194546,194621,1,75,trnSL-Gln2,45.33333333333333,
452,CDS,194848,195412,1,564,sigW,59.39716312056738,
451,gene,194848,195412,1,564,sigW,59.39716312056738,
453,gene,195425,196052,1,627,rsiW,55.02392344497608,
454,CDS,195425,196052,1,627,rsiW,55.02392344497608,
455,gene,196212,197034,1,822,cdaA,53.52798053527981,
456,CDS,196212,197034,1,822,cdaA,53.52798053527981,
458,CDS,197026,198478,1,1452,cdaR,57.5068870523416,
457,gene,197026,198478,1,1452,cdaR,57.5068870523416,
459,gene,198496,199843,1,1347,glmM,52.41276911655531,
460,CDS,198496,199843,1,1347,glmM,52.41276911655531,
462,misc_RNA,200016,200187,1,171,glmSA,51.461988304093566,
461,gene,200016,200187,1,171,glmSA,51.461988304093566,
463,gene,200276,202079,1,1803,glmS,52.967276760953965,
464,CDS,200276,202079,1,1803,glmS,52.967276760953965,
465,gene,202125,202266,1,141,ybbU,60.99290780141844,
466,CDS,202125,202266,1,141,ybbU,60.99290780141844,
467,gene,202546,203458,-1,912,alkA,63.04824561403509,
468,CDS,202546,203458,-1,912,alkA,63.04824561403509,
470,CDS,203728,204364,1,636,adaA,64.62264150943396,
469,gene,203728,204364,1,636,adaA,64.62264150943396,
472,CDS,204350,204890,1,540,adaB,58.333333333333336,
471,gene,204350,204890,1,540,adaB,58.333333333333336,
473,gene,205408,206926,1,1518,ndhF,58.76152832674572,
474,CDS,205408,206926,1,1518,ndhF,58.76152832674572,
475,gene,206940,209556,1,2616,ybcC,57.7217125382263,
476,CDS,206940,209556,1,2616,ybcC,57.7217125382263,
478,CDS,209632,210160,1,528,ybcF,63.82575757575758,
477,gene,209632,210160,1,528,ybcF,63.82575757575758,
480,CDS,210223,210514,1,291,ybcH,69.41580756013745,
479,gene,210223,210514,1,291,ybcH,69.41580756013745,
481,gene,210571,210946,1,375,ybcI,64.26666666666667,
482,CDS,210571,210946,1,375,ybcI,64.26666666666667,
483,gene,211428,211731,1,303,ybzH,60.726072607260726,
484,CDS,211428,211731,1,303,ybzH,60.726072607260726,
485,gene,211858,213031,1,1173,ybcL,55.58397271952259,
486,CDS,211858,213031,1,1173,ybcL,55.58397271952259,
487,gene,213154,213469,1,315,ybcM,52.6984126984127,
488,CDS,213154,213469,1,315,ybcM,52.6984126984127,
489,gene,213940,214108,1,168,skfA,55.35714285714286,
490,CDS,213940,214108,1,168,skfA,55.35714285714286,
491,gene,214174,215407,1,1233,skfB,60.746147607461474,
492,CDS,214174,215407,1,1233,skfB,60.746147607461474,
494,CDS,215403,216894,1,1491,skfC,62.57545271629779,
493,gene,215403,216894,1,1491,skfC,62.57545271629779,
496,CDS,216912,217632,1,720,skfE,58.19444444444445,
495,gene,216912,217632,1,720,skfE,58.19444444444445,
497,gene,217696,219040,1,1344,skfF,62.425595238095234,
498,CDS,217696,219040,1,1344,skfF,62.425595238095234,
499,gene,219086,219602,1,516,skfG,58.333333333333336,
500,CDS,219086,219602,1,516,skfG,58.333333333333336,
501,gene,219606,220032,1,426,skfH,62.676056338028175,
502,CDS,219606,220032,1,426,skfH,62.676056338028175,
503,gene,220278,221256,1,978,ybdG,59.50920245398773,
504,CDS,220278,221256,1,978,ybdG,59.50920245398773,
505,gene,221257,221929,1,672,ybdJ,60.11904761904761,
506,CDS,221257,221929,1,672,ybdJ,60.11904761904761,
507,gene,221949,222912,1,963,ybdK,60.53997923156802,
508,CDS,221949,222912,1,963,ybdK,60.53997923156802,
510,CDS,222970,223234,1,264,ybzI,54.54545454545454,
509,gene,222970,223234,1,264,ybzI,54.54545454545454,
512,CDS,223218,223989,-1,771,ybdM,58.2360570687419,
511,gene,223218,223989,-1,771,ybdM,58.2360570687419,
513,gene,224074,224932,-1,858,ybdN,59.09090909090909,
514,CDS,224074,224932,-1,858,ybdN,59.09090909090909,
515,gene,225063,226248,1,1185,ybdO,56.87763713080168,
516,CDS,225063,226248,1,1185,ybdO,56.87763713080168,
518,CDS,226565,227954,1,1389,ybxG,54.06767458603312,
517,gene,226565,227954,1,1389,ybxG,54.06767458603312,
520,CDS,228065,228314,1,249,csgA,63.45381526104418,
519,gene,228065,228314,1,249,csgA,63.45381526104418,
521,gene,228330,228522,1,192,ybxH,59.895833333333336,
522,CDS,228330,228522,1,192,ybxH,59.895833333333336,
523,gene,228548,229352,-1,804,ybxI,55.09950248756219,
524,CDS,228548,229352,-1,804,ybxI,55.09950248756219,
525,gene,229524,230778,1,1254,cypC,51.43540669856459,
526,CDS,229524,230778,1,1254,cypC,51.43540669856459,
528,CDS,230818,231079,-1,261,ybyB,57.8544061302682,
527,gene,230818,231079,-1,261,ybyB,57.8544061302682,
530,CDS,231347,232967,1,1620,ybeC,54.50617283950617,
529,gene,231347,232967,1,1620,ybeC,54.50617283950617,
531,gene,233013,233895,-1,882,glpQA,54.53514739229025,
532,CDS,233013,233895,-1,882,glpQA,54.53514739229025,
533,gene,233993,235328,-1,1335,glpT,53.558052434456926,
534,CDS,233993,235328,-1,1335,glpT,53.558052434456926,
536,CDS,235624,235873,1,249,ybeF,63.45381526104418,
535,gene,235624,235873,1,249,ybeF,63.45381526104418,
538,CDS,235964,236882,1,918,ybfA,55.773420479302835,
537,gene,235964,236882,1,918,ybfA,55.773420479302835,
539,gene,236878,238129,1,1251,ybfB,49.16067146282973,
540,CDS,236878,238129,1,1251,ybfB,49.16067146282973,
541,gene,238163,238448,-1,285,ybfEc,67.01754385964912,
542,misc_feature,238163,238448,-1,285,ybfEc,67.01754385964912,
543,gene,238353,238476,-1,123,ybfEn,69.10569105691057,
544,misc_feature,238353,238476,-1,123,ybfEn,69.10569105691057,
546,CDS,238643,239555,-1,912,ybfF,70.83333333333334,
545,gene,238643,239555,-1,912,ybfF,70.83333333333334,
548,CDS,239643,241842,-1,2199,ybfG,58.07185084129149,
547,gene,239643,241842,-1,2199,ybfG,58.07185084129149,
549,gene,241916,242837,-1,921,ybfH,55.48317046688383,
550,CDS,241916,242837,-1,921,ybfH,55.48317046688383,
551,gene,242833,243661,-1,828,ybfI,56.15942028985508,
552,CDS,242833,243661,-1,828,ybfI,56.15942028985508,
553,gene,243891,245046,1,1155,purT,50.82251082251082,
554,CDS,243891,245046,1,1155,purT,50.82251082251082,
555,gene,245189,246131,1,942,mpr,53.397027600849256,
556,CDS,245189,246131,1,942,mpr,53.397027600849256,
557,gene,246093,246492,1,399,ybfJ,57.393483709273184,
558,CDS,246093,246492,1,399,ybfJ,57.393483709273184,
559,gene,246657,247548,1,891,cesB,52.41301907968574,
560,CDS,246657,247548,1,891,cesB,52.41301907968574,
561,gene,247743,248277,1,534,pssA,55.80524344569289,
562,CDS,247743,248277,1,534,pssA,55.80524344569289,
563,gene,248267,248756,1,489,ybfM,59.50920245398773,
564,CDS,248267,248756,1,489,ybfM,59.50920245398773,
565,gene,248748,249540,1,792,psd,53.28282828282829,
566,CDS,248748,249540,1,792,psd,53.28282828282829,
568,CDS,249594,249873,1,279,ybfN,55.55555555555556,
567,gene,249594,249873,1,279,ybfN,55.55555555555556,
569,gene,249978,251319,1,1341,ybfO,56.82326621923938,
570,CDS,249978,251319,1,1341,ybfO,56.82326621923938,
571,gene,251426,252314,1,888,ybfP,60.36036036036037,
572,CDS,251426,252314,1,888,ybfP,60.36036036036037,
573,gene,252513,253482,1,969,ybfQ,55.83075335397317,
574,CDS,252513,253482,1,969,ybfQ,55.83075335397317,
575,gene,253517,254762,-1,1245,gltP,54.37751004016064,
576,CDS,253517,254762,-1,1245,gltP,54.37751004016064,
577,gene,254906,256802,-1,1896,gamP,51.47679324894515,
578,CDS,254906,256802,-1,1896,gamP,51.47679324894515,
579,gene,256822,257572,-1,750,gamA,55.06666666666666,
580,CDS,256822,257572,-1,750,gamA,55.06666666666666,
582,CDS,257790,258498,1,708,gamR,56.355932203389834,
581,gene,257790,258498,1,708,gamR,56.355932203389834,
584,CDS,258531,258807,1,276,ybgB,55.434782608695656,
583,gene,258531,258807,1,276,ybgB,55.434782608695656,
585,gene,259015,260086,1,1071,ilvE,51.72735760971056,
586,CDS,259015,260086,1,1071,ilvE,51.72735760971056,
587,gene,260122,261535,-1,1413,ybgF,50.955414012738856,
588,CDS,260122,261535,-1,1413,ybgF,50.955414012738856,
590,CDS,261655,262603,-1,948,ybgG,49.472573839662445,
589,gene,261655,262603,-1,948,ybgG,49.472573839662445,
592,CDS,262731,264168,-1,1437,glnT,53.16631871955463,
591,gene,262731,264168,-1,1437,glnT,53.16631871955463,
593,gene,264190,265174,-1,984,glsA,50.609756097560975,
594,CDS,264190,265174,-1,984,glsA,50.609756097560975,
595,gene,265475,266708,1,1233,glnJ,54.66342254663422,
596,CDS,265475,266708,1,1233,glnJ,54.66342254663422,
597,gene,266718,267663,1,945,glnL,53.333333333333336,
598,CDS,266718,267663,1,945,glnL,53.333333333333336,
600,CDS,267889,268816,1,927,kdgD,51.56418554476807,
599,gene,267889,268816,1,927,kdgD,51.56418554476807,
602,CDS,268845,270312,1,1467,gucD,48.670756646216766,
601,gene,268845,270312,1,1467,gucD,48.670756646216766,
603,gene,270395,271763,1,1368,gudP,50.58479532163743,
604,CDS,270395,271763,1,1368,gudP,50.58479532163743,
605,gene,271799,273167,1,1368,gudD,47.514619883040936,
606,CDS,271799,273167,1,1368,gudD,47.514619883040936,
608,CDS,273236,273938,1,702,garR,54.27350427350427,
607,gene,273236,273938,1,702,garR,54.27350427350427,
610,CDS,274028,275561,1,1533,garD,47.227658186562294,
609,gene,274028,275561,1,1533,garD,47.227658186562294,
611,gene,275837,276758,1,921,ycbJ,52.22584147665581,
612,CDS,275837,276758,1,921,ycbJ,52.22584147665581,
613,gene,276814,277062,1,248,tboW,50.0,
614,misc_RNA,276814,277062,1,248,tboW,50.0,
615,gene,277159,277321,1,162,rtpA,56.17283950617284,
616,CDS,277159,277321,1,162,rtpA,56.17283950617284,
618,CDS,277341,278280,1,939,ycbK,52.39616613418531,
617,gene,277341,278280,1,939,ycbK,52.39616613418531,
620,CDS,278376,279057,1,681,ycbL,54.77239353891336,
619,gene,278376,279057,1,681,ycbL,54.77239353891336,
621,gene,279058,279994,1,936,ycbM,53.52564102564102,
622,CDS,279058,279994,1,936,ycbM,53.52564102564102,
623,gene,280085,281009,1,924,ycbN,55.62770562770562,
624,CDS,280085,281009,1,924,ycbN,55.62770562770562,
625,gene,281027,281714,1,687,ycbO,54.58515283842795,
626,CDS,281027,281714,1,687,ycbO,54.58515283842795,
627,gene,281674,281809,-1,135,BSU_02585,53.333333333333336,
628,CDS,281674,281809,-1,135,BSU_02585,53.333333333333336,
629,gene,281768,282155,-1,387,ycbP,57.105943152454785,
630,CDS,281768,282155,-1,387,ycbP,57.105943152454785,
631,gene,282468,282897,1,429,cwlJ,47.785547785547784,
632,CDS,282468,282897,1,429,cwlJ,47.785547785547784,spore cortex cell wall hydrolase
633,gene,283002,283734,1,732,ycbR,57.650273224043715,
634,CDS,283002,283734,1,732,ycbR,57.650273224043715,
636,CDS,283815,283992,1,177,yczK,55.367231638418076,
635,gene,283815,283992,1,177,yczK,55.367231638418076,
638,CDS,284010,285762,1,1752,phoD,51.31278538812786,secreted phosphodiesterase (endo-hydrolysis at non-specific sites throughout the cell wall teichoic acid polymer)
637,gene,284010,285762,1,1752,phoD,51.31278538812786,
639,gene,285774,285987,1,213,tatAD,51.173708920187785,
640,CDS,285774,285987,1,213,tatAD,51.173708920187785,
641,gene,286047,286776,1,729,tatCD,52.674897119341566,
642,CDS,286047,286776,1,729,tatCD,52.674897119341566,
644,CDS,286772,287420,-1,648,pcp,50.0,
643,gene,286772,287420,-1,648,pcp,50.0,
646,CDS,287498,288611,1,1113,ycbU,50.314465408805034,
645,gene,287498,288611,1,1113,ycbU,50.314465408805034,
647,gene,288652,290092,-1,1440,lmrB,52.63888888888889,
648,CDS,288652,290092,-1,1440,lmrB,52.63888888888889,
649,gene,290131,290698,-1,567,lmrA,48.85361552028218,
650,CDS,290131,290698,-1,567,lmrA,48.85361552028218,
652,CDS,290914,292042,1,1128,ansZ,55.40780141843972,
651,gene,290914,292042,1,1128,ansZ,55.40780141843972,
653,gene,292204,292843,1,639,estA,54.929577464788736,
654,CDS,292204,292843,1,639,estA,54.929577464788736,
656,CDS,292880,293264,-1,384,yczC,52.864583333333336,
655,gene,292880,293264,-1,384,yczC,52.864583333333336,
657,gene,293498,294575,1,1077,yccF,53.38904363974002,
658,CDS,293498,294575,1,1077,yccF,53.38904363974002,
659,gene,294614,295571,-1,957,natK,52.769070010449326,
660,CDS,294614,295571,-1,957,natK,52.769070010449326,
661,gene,295583,296285,-1,702,natR,56.98005698005698,
662,CDS,295583,296285,-1,702,natR,56.98005698005698,
664,CDS,296428,297169,1,741,natA,52.90148448043185,
663,gene,296428,297169,1,741,natA,52.90148448043185,
666,CDS,297169,298330,1,1161,natB,55.12489233419466,
665,gene,297169,298330,1,1161,natB,55.12489233419466,
667,gene,298465,299398,1,933,yccK,53.69774919614147,
668,CDS,298465,299398,1,933,yccK,53.69774919614147,
669,gene,299437,300502,-1,1065,ycdA,60.093896713615024,
670,CDS,299437,300502,-1,1065,ycdA,60.093896713615024,
672,CDS,300524,300656,-1,132,BSU_02785,62.121212121212125,
671,gene,300524,300656,-1,132,BSU_02785,62.121212121212125,
674,CDS,300829,302248,1,1419,ycdB,52.360817477096546,
673,gene,300829,302248,1,1419,ycdB,52.360817477096546,
675,gene,302434,303796,1,1362,ycdC,54.478707782672544,
676,CDS,302434,303796,1,1362,ycdC,54.478707782672544,
677,gene,303803,304307,-1,504,cwlK,57.341269841269835,
678,CDS,303803,304307,-1,504,cwlK,57.341269841269835,
679,gene,304429,305551,1,1122,rapJ,56.59536541889483,
680,CDS,304429,305551,1,1122,rapJ,56.59536541889483,
681,gene,305657,306434,1,777,ycdF,52.25225225225225,
682,CDS,305657,306434,1,777,ycdF,52.25225225225225,
683,gene,306458,308144,1,1686,ycdG,54.092526690391466,
684,CDS,306458,308144,1,1686,ycdG,54.092526690391466,
685,gene,308331,309291,1,960,znuA,57.70833333333333,
686,CDS,308331,309291,1,960,znuA,57.70833333333333,
688,CDS,309346,310042,1,696,znuC,55.89080459770115,
687,gene,309346,310042,1,696,znuC,55.89080459770115,
690,CDS,309999,310842,1,843,znuB,54.44839857651246,
689,gene,309999,310842,1,843,znuB,54.44839857651246,
691,gene,310879,311875,-1,996,yceB,50.20080321285141,
692,CDS,310879,311875,-1,996,yceB,50.20080321285141,
693,gene,312158,312758,1,600,yceC,54.50000000000001,
694,CDS,312158,312758,1,600,yceC,54.50000000000001,
696,CDS,312779,313361,1,582,yceD,54.123711340206185,
695,gene,312779,313361,1,582,yceD,54.123711340206185,
698,CDS,313395,313974,1,579,yceE,52.331606217616574,
697,gene,313395,313974,1,579,yceE,52.331606217616574,
699,gene,314024,314798,1,774,yceF,55.55555555555556,
700,CDS,314024,314798,1,774,yceF,55.55555555555556,
701,gene,314882,316496,1,1614,yceG,54.646840148698885,
702,CDS,314882,316496,1,1614,yceG,54.646840148698885,
703,gene,316511,317603,1,1092,yceH,54.21245421245421,
704,CDS,316511,317603,1,1092,yceH,54.21245421245421,
706,CDS,317724,318927,1,1203,niaP,50.20781379883624,
705,gene,317724,318927,1,1203,niaP,50.20781379883624,
708,CDS,319179,320352,-1,1173,yceJ,51.406649616368284,
707,gene,319179,320352,-1,1173,yceJ,51.406649616368284,
710,CDS,320420,320723,-1,303,yceK,58.415841584158414,
709,gene,320420,320723,-1,303,yceK,58.415841584158414,
711,gene,321012,322269,1,1257,opuAA,56.324582338902154,
712,CDS,321012,322269,1,1257,opuAA,56.324582338902154,
713,gene,322270,323119,1,849,opuAB,54.06360424028268,
714,CDS,322270,323119,1,849,opuAB,54.06360424028268,
715,gene,323118,324000,1,882,opuAC,53.74149659863946,
716,CDS,323118,324000,1,882,opuAC,53.74149659863946,
718,CDS,324037,325189,-1,1152,amhX,48.78472222222222,
717,gene,324037,325189,-1,1152,amhX,48.78472222222222,
719,gene,325338,326772,1,1434,ycgA,53.06834030683403,
720,CDS,325338,326772,1,1434,ycgA,53.06834030683403,
721,gene,326887,327469,1,582,ycgB,57.56013745704467,
722,CDS,326887,327469,1,582,ycgB,57.56013745704467,
723,gene,327617,329597,1,1980,amyE,55.45454545454545,
724,CDS,327617,329597,1,1980,amyE,55.45454545454545,
725,gene,329773,330739,1,966,lctE,55.072463768115945,
726,CDS,329773,330739,1,966,lctE,55.072463768115945,
727,gene,330770,332396,1,1626,lctP,50.2460024600246,
728,CDS,330770,332396,1,1626,lctP,50.2460024600246,
729,gene,332440,333979,-1,1539,mdr,53.021442495126706,
730,CDS,332440,333979,-1,1539,mdr,53.021442495126706,
731,gene,334091,334556,1,465,ycgE,51.3978494623656,
732,CDS,334091,334556,1,465,ycgE,51.3978494623656,
734,CDS,334629,335259,1,630,ycgF,54.44444444444444,
733,gene,334629,335259,1,630,ycgF,54.44444444444444,
735,gene,335328,336090,1,762,ycgG,52.0997375328084,
736,CDS,335328,336090,1,762,ycgG,52.0997375328084,
737,gene,336091,337432,-1,1341,ycgH,53.24384787472036,
738,CDS,336091,337432,-1,1341,ycgH,53.24384787472036,
739,gene,337561,338158,1,597,ycgI,52.76381909547738,
740,CDS,337561,338158,1,597,ycgI,52.76381909547738,
741,gene,338287,339106,1,819,nadE,51.8925518925519,
742,CDS,338287,339106,1,819,nadE,51.8925518925519,
743,gene,339155,339749,-1,594,tmrB,52.861952861952865,
744,CDS,339155,339749,-1,594,tmrB,52.861952861952865,
745,gene,340024,340585,1,561,aroK,59.71479500891266,
746,CDS,340024,340585,1,561,aroK,59.71479500891266,
747,gene,340612,341374,-1,762,ycgJ,51.83727034120735,
748,CDS,340612,341374,-1,762,ycgJ,51.83727034120735,
749,gene,341491,342466,1,975,ycgK,51.38461538461539,
750,CDS,341491,342466,1,975,ycgK,51.38461538461539,
751,gene,342537,343494,1,957,cah,51.410658307210035,
752,CDS,342537,343494,1,957,cah,51.410658307210035,
753,gene,343577,344360,1,783,ycgL,56.06641123882503,
754,CDS,343577,344360,1,783,ycgL,56.06641123882503,
755,gene,344550,345462,1,912,putB,56.57894736842105,
756,CDS,344550,345462,1,912,putB,56.57894736842105,
757,gene,345478,347026,1,1548,putC,53.48837209302325,
758,CDS,345478,347026,1,1548,putC,53.48837209302325,
759,gene,347149,348571,1,1422,putP,51.33614627285513,
760,CDS,347149,348571,1,1422,putP,51.33614627285513,
761,gene,348723,349959,1,1236,putR,60.27508090614887,
762,CDS,348723,349959,1,1236,putR,60.27508090614887,
763,gene,349995,350853,-1,858,ycgQ,58.857808857808855,
764,CDS,349995,350853,-1,858,ycgQ,58.857808857808855,
765,gene,350857,351742,-1,885,ycgR,54.23728813559322,
766,CDS,350857,351742,-1,885,ycgR,54.23728813559322,
767,gene,351841,352696,-1,855,ycgS,53.567251461988306,
768,CDS,351841,352696,-1,855,ycgS,53.567251461988306,
769,gene,352857,353868,1,1011,ffoR,49.752720079129574,
770,CDS,352857,353868,1,1011,ffoR,49.752720079129574,
771,gene,353899,355351,-1,1452,nasF,50.6198347107438,
772,CDS,353899,355351,-1,1452,nasF,50.6198347107438,
773,gene,355411,355732,-1,321,nasE,55.45171339563863,
774,CDS,355411,355732,-1,321,nasE,55.45171339563863,
775,gene,355763,358181,-1,2418,nasD,50.909842845326715,
776,CDS,355763,358181,-1,2418,nasD,50.909842845326715,
777,gene,358302,360435,-1,2133,nasC,51.57055789967182,
778,CDS,358302,360435,-1,2133,nasC,51.57055789967182,
779,gene,360441,362757,-1,2316,nasB,50.56131260794473,
780,CDS,360441,362757,-1,2316,nasB,50.56131260794473,
781,gene,362936,364142,1,1206,nasA,49.004975124378106,
782,CDS,362936,364142,1,1206,nasA,49.004975124378106,
783,gene,364258,365173,1,915,folEB,53.98907103825137,
784,CDS,364258,365173,1,915,folEB,53.98907103825137,
785,gene,365169,365754,1,585,yciB,58.2905982905983,
786,CDS,365169,365754,1,585,yciB,58.2905982905983,
787,gene,365849,366035,1,186,yczL,54.83870967741935,
788,CDS,365849,366035,1,186,yczL,54.83870967741935,
789,gene,366062,367256,1,1194,zinU,52.93132328308208,
790,CDS,366062,367256,1,1194,zinU,52.93132328308208,
791,gene,367304,367985,-1,681,yckA,54.62555066079295,
792,CDS,367304,367985,-1,681,yckA,54.62555066079295,
793,gene,367994,368858,-1,864,yckB,54.861111111111114,
794,CDS,367994,368858,-1,864,yckB,54.861111111111114,
796,CDS,369019,369217,1,198,BSU_03385,58.58585858585859,
795,gene,369019,369217,1,198,BSU_03385,58.58585858585859,
798,CDS,369235,369691,1,456,yckC,56.35964912280702,
797,gene,369235,369691,1,456,yckC,56.35964912280702,
799,gene,369772,370105,1,333,yckD,60.06006006006006,
800,CDS,369772,370105,1,333,yckD,60.06006006006006,
801,gene,370258,371692,1,1434,bglC,56.903765690376574,
802,CDS,370258,371692,1,1434,bglC,56.903765690376574,
804,CDS,371728,372127,-1,399,nin,60.150375939849624,
803,gene,371728,372127,-1,399,nin,60.150375939849624,
806,CDS,372153,372603,-1,450,nucA,52.22222222222223,
805,gene,372153,372603,-1,450,nucA,52.22222222222223,
807,gene,372770,374492,-1,1722,tlpC,57.66550522648084,
808,CDS,372770,374492,-1,1722,tlpC,57.66550522648084,
809,gene,374602,375160,-1,558,hxlB,55.017921146953405,
810,CDS,374602,375160,-1,558,hxlB,55.017921146953405,
811,gene,375165,375798,-1,633,hxlA,55.45023696682464,
812,CDS,375165,375798,-1,633,hxlA,55.45023696682464,
813,gene,376031,376394,1,363,hxlR,58.40220385674931,
814,CDS,376031,376394,1,363,hxlR,58.40220385674931,
816,CDS,376967,387731,1,10764,srfAA,50.297287253808996,
815,gene,376967,387731,1,10764,srfAA,50.297287253808996,
817,gene,387743,398495,1,10752,srfAB,49.53497023809524,
818,CDS,387743,398495,1,10752,srfAB,49.53497023809524,
819,gene,390879,391020,1,141,comS,49.645390070921984,
820,CDS,390879,391020,1,141,comS,49.645390070921984,
822,CDS,398531,402359,1,3828,srfAC,50.9926854754441,
821,gene,398531,402359,1,3828,srfAC,50.9926854754441,
823,gene,402387,403116,1,729,srfAD,49.93141289437586,
824,CDS,402387,403116,1,729,srfAD,49.93141289437586,
826,CDS,403216,404443,1,1227,srfT,51.34474327628362,
825,gene,403216,404443,1,1227,srfT,51.34474327628362,
827,gene,404457,405015,-1,558,ycxB,65.59139784946237,
828,CDS,404457,405015,-1,558,ycxB,65.59139784946237,
829,gene,405068,406007,-1,939,ycxC,52.18317358892439,
830,CDS,405068,406007,-1,939,ycxC,52.18317358892439,
832,CDS,406130,407465,1,1335,ycxD,52.58426966292134,
831,gene,406130,407465,1,1335,ycxD,52.58426966292134,
834,misc_feature,407459,407627,-1,168,sfpAc,49.404761904761905,
833,gene,407459,407627,-1,168,sfpAc,49.404761904761905,
835,gene,407637,408135,-1,498,sfpAn,54.41767068273092,
836,misc_feature,407637,408135,-1,498,sfpAn,54.41767068273092,
837,gene,408239,408887,-1,648,yczE,50.308641975308646,
838,CDS,408239,408887,-1,648,yczE,50.308641975308646,
839,gene,409207,409951,-1,744,tcyC,49.73118279569893,
840,CDS,409207,409951,-1,744,tcyC,49.73118279569893,
841,gene,409964,410669,-1,705,tcyB,52.6241134751773,
842,CDS,409964,410669,-1,705,tcyB,52.6241134751773,
843,gene,410655,411462,-1,807,tcyA,58.48822800495663,
844,CDS,410655,411462,-1,807,tcyA,58.48822800495663,
845,gene,411577,412450,-1,873,bsdA,54.18098510882016,
846,CDS,411577,412450,-1,873,bsdA,54.18098510882016,
847,gene,412539,413154,1,615,ubiX,51.056910569105696,
848,CDS,412539,413154,1,615,ubiX,51.056910569105696,
849,gene,413156,414578,1,1422,bsdC,52.18002812939522,
850,CDS,413156,414578,1,1422,bsdC,52.18002812939522,
852,CDS,414594,414822,1,228,bsdD,56.14035087719298,
851,gene,414594,414822,1,228,bsdD,56.14035087719298,
853,gene,414818,415283,1,465,yclD,49.89247311827957,
854,CDS,414818,415283,1,465,yclD,49.89247311827957,
855,gene,415349,416195,1,846,yclE,53.30969267139481,
856,CDS,415349,416195,1,846,yclE,53.30969267139481,
857,gene,416234,417713,-1,1479,dtpT,53.88776200135227,
858,CDS,416234,417713,-1,1479,dtpT,53.88776200135227,
859,gene,417992,419747,1,1755,yclG,55.15669515669516,
860,CDS,417992,419747,1,1755,yclG,55.15669515669516,
862,CDS,419762,419984,-1,222,yczF,65.31531531531532,
861,gene,419762,419984,-1,222,yczF,65.31531531531532,
863,gene,420109,421744,1,1635,gerKA,52.78287461773701,
864,CDS,420109,421744,1,1635,gerKA,52.78287461773701,
865,gene,421733,422957,1,1224,gerKC,55.14705882352941,
866,CDS,421733,422957,1,1224,gerKC,55.14705882352941,
868,CDS,422981,424103,1,1122,gerKB,57.21925133689839,
867,gene,422981,424103,1,1122,gerKB,57.21925133689839,
870,CDS,424207,424888,-1,681,yclH,55.947136563876654,
869,gene,424207,424888,-1,681,yclH,55.947136563876654,
871,gene,424903,426364,-1,1461,yclI,55.23613963039015,
872,CDS,424903,426364,-1,1461,yclI,55.23613963039015,
873,gene,426576,427260,1,684,yclJ,56.72514619883041,
874,CDS,426576,427260,1,684,yclJ,56.72514619883041,
876,CDS,427246,428668,1,1422,yclK,56.32911392405063,
875,gene,427246,428668,1,1422,yclK,56.32911392405063,
877,gene,428830,429979,1,1149,rapC,60.48738033072236,
878,CDS,428830,429979,1,1149,rapC,60.48738033072236,
879,gene,429962,430085,1,123,phrC,56.91056910569105,
880,CDS,429962,430085,1,123,phrC,56.91056910569105,
881,gene,430184,430274,-1,90,yczM,61.111111111111114,
882,CDS,430184,430274,-1,90,yczM,61.111111111111114,
884,CDS,430355,430469,-1,114,yczN,56.14035087719298,
883,gene,430355,430469,-1,114,yczN,56.14035087719298,
886,CDS,430622,431987,-1,1365,thrD,50.91575091575091,
885,gene,430622,431987,-1,1365,thrD,50.91575091575091,
888,CDS,432371,433322,1,951,pbtN,55.83596214511041,
887,gene,432371,433322,1,951,pbtN,55.83596214511041,
889,gene,433314,434262,1,948,pbtO,56.223628691983116,
890,CDS,433314,434262,1,948,pbtO,56.223628691983116,
891,gene,434255,435014,1,759,pbtP,55.73122529644269,
892,CDS,434255,435014,1,759,pbtP,55.73122529644269,
893,gene,435035,435989,1,954,pbtQ,59.329140461215935,
894,CDS,435035,435989,1,954,pbtQ,59.329140461215935,
895,gene,436035,437454,-1,1419,ycnB,50.317124735729394,
896,CDS,436035,437454,-1,1419,ycnB,50.317124735729394,
897,gene,437473,438352,-1,879,ycnC,54.26621160409556,
898,CDS,437473,438352,-1,879,ycnC,54.26621160409556,
899,gene,438515,439265,-1,750,nfrAB,52.26666666666666,
900,CDS,438515,439265,-1,750,nfrAB,52.26666666666666,
901,gene,439281,439569,-1,288,ycnE,57.638888888888886,
902,CDS,439281,439569,-1,288,ycnE,57.638888888888886,
904,CDS,439708,440023,1,315,yczG,53.65079365079365,
903,gene,439708,440023,1,315,yczG,53.65079365079365,
906,CDS,440024,441464,-1,1440,gabR,51.041666666666664,
905,gene,440024,441464,-1,1440,gabR,51.041666666666664,
907,gene,441570,442881,1,1311,gabT,49.275362318840585,
908,CDS,441570,442881,1,1311,gabT,49.275362318840585,
909,gene,442949,444338,1,1389,gabD,49.892008639308855,
910,CDS,442949,444338,1,1389,gabD,49.892008639308855,
911,gene,444460,445324,1,864,glcU,54.513888888888886,
912,CDS,444460,445324,1,864,glcU,54.513888888888886,
913,gene,445343,446129,1,786,gdh,53.05343511450382,
914,CDS,445343,446129,1,786,gdh,53.05343511450382,
915,gene,446173,446788,-1,615,cutI,52.19512195121951,
916,CDS,446173,446788,-1,615,cutI,52.19512195121951,
917,gene,446800,448426,-1,1626,cutJ,51.35301353013531,
918,CDS,446800,448426,-1,1626,cutJ,51.35301353013531,
920,CDS,448460,449033,-1,573,cutR,51.832460732984295,
919,gene,448460,449033,-1,573,cutR,51.832460732984295,
922,CDS,449197,449551,1,354,ycnL,52.259887005649716,
921,gene,449197,449551,1,354,ycnL,52.259887005649716,
924,CDS,449723,451160,1,1437,mtlA,51.496172581767574,
923,gene,449723,451160,1,1437,mtlA,51.496172581767574,
925,gene,451184,451616,1,432,mtlF,57.638888888888886,
926,CDS,451184,451616,1,432,mtlF,57.638888888888886,
927,gene,451617,452739,1,1122,mtlD,52.04991087344028,
928,CDS,451617,452739,1,1122,mtlD,52.04991087344028,
929,gene,452829,453894,1,1065,ycsA,50.42253521126761,
930,CDS,452829,453894,1,1065,ycsA,50.42253521126761,
931,gene,454028,454592,1,564,sipU,60.815602836879435,
932,CDS,454028,454592,1,564,sipU,60.815602836879435,
933,gene,454651,455260,-1,609,yczH,53.69458128078818,
934,CDS,454651,455260,-1,609,yczH,53.69458128078818,
936,CDS,455345,455738,1,393,ycsD,52.67175572519084,
935,gene,455345,455738,1,393,ycsD,52.67175572519084,
937,gene,455770,455935,-1,165,yczO,61.212121212121204,
938,CDS,455770,455935,-1,165,yczO,61.212121212121204,
939,gene,456067,456817,1,750,ribZ,54.0,
940,CDS,456067,456817,1,750,ribZ,54.0,
942,CDS,457022,457796,1,774,pxpA,51.162790697674424,
941,gene,457022,457796,1,774,pxpA,51.162790697674424,
944,CDS,457810,459025,1,1215,pxpG,52.345679012345684,
943,gene,457810,459025,1,1215,pxpG,52.345679012345684,
945,gene,459048,459822,1,774,pxpI,46.770025839793284,
946,CDS,459048,459822,1,774,pxpI,46.770025839793284,
947,gene,459866,460589,1,723,pxpB,51.037344398340245,
948,CDS,459866,460589,1,723,pxpB,51.037344398340245,
950,CDS,460591,461599,1,1008,pxpC,48.41269841269841,
949,gene,460591,461599,1,1008,pxpC,48.41269841269841,
951,gene,461614,462367,1,753,pxpR,50.59760956175299,
952,CDS,461614,462367,1,753,pxpR,50.59760956175299,
954,CDS,462430,463072,1,642,lipC,54.98442367601246,
953,gene,462430,463072,1,642,lipC,54.98442367601246,
955,gene,463244,463490,1,246,yczI,61.382113821138205,
956,CDS,463244,463490,1,246,yczI,61.382113821138205,
958,CDS,463495,463783,-1,288,yczJ,52.77777777777778,
957,gene,463495,463783,-1,288,yczJ,52.77777777777778,
960,CDS,463933,465940,1,2007,pbpC,55.40607872446437,
959,gene,463933,465940,1,2007,pbpC,55.40607872446437,
962,CDS,466041,466944,1,903,ycsN,51.38427464008859,
961,gene,466041,466944,1,903,ycsN,51.38427464008859,
963,gene,467129,469214,1,2085,mtlR,54.91606714628298,
964,CDS,467129,469214,1,2085,mtlR,54.91606714628298,
965,gene,469425,470937,1,1512,ydaB,55.48941798941799,
966,CDS,469425,470937,1,1512,ydaB,55.48941798941799,
967,gene,470956,471502,-1,546,ydaC,52.197802197802204,
968,CDS,470956,471502,-1,546,ydaC,52.197802197802204,
970,CDS,471708,472569,1,861,ydaD,51.91637630662021,
969,gene,471708,472569,1,861,ydaD,51.91637630662021,
972,CDS,472584,473088,1,504,lyxE,50.79365079365079,
971,gene,472584,473088,1,504,lyxE,50.79365079365079,
973,gene,473173,473725,1,552,ydaF,50.18115942028986,
974,CDS,473173,473725,1,552,ydaF,50.18115942028986,
975,gene,473802,474225,1,423,ydaG,57.21040189125296,
976,CDS,473802,474225,1,423,ydaG,57.21040189125296,
978,misc_RNA,474328,474597,-1,269,bsrC,56.50557620817844,
977,gene,474328,474597,-1,269,bsrC,56.50557620817844,
979,gene,474730,475540,1,810,amj,53.95061728395062,
980,CDS,474730,475540,1,810,amj,53.95061728395062,
981,gene,475583,475874,-1,291,ydzA,52.23367697594502,
982,CDS,475583,475874,-1,291,ydzA,52.23367697594502,
983,gene,476058,476493,1,435,lrpC,54.71264367816092,
984,CDS,476058,476493,1,435,lrpC,54.71264367816092,
985,gene,476557,478741,1,2184,topB,51.739926739926744,
986,CDS,476557,478741,1,2184,topB,51.739926739926744,
987,gene,478943,480032,1,1089,epsJ,55.55555555555556,
988,CDS,478943,480032,1,1089,epsJ,55.55555555555556,
990,CDS,480012,480864,1,852,epsK,55.16431924882629,
989,gene,480012,480864,1,852,epsK,55.16431924882629,
991,gene,480874,482584,1,1710,ydaL,53.918128654970765,
992,CDS,480874,482584,1,1710,ydaL,53.918128654970765,
994,CDS,482576,483839,1,1263,ydaM,54.790182106096594,
993,gene,482576,483839,1,1263,ydaM,54.790182106096594,
995,gene,483844,485956,1,2112,ydaN,54.166666666666664,
996,CDS,483844,485956,1,2112,ydaN,54.166666666666664,
997,gene,486091,486235,1,144,swaO,52.083333333333336,
998,misc_RNA,486091,486235,1,144,swaO,52.083333333333336,
999,gene,486431,488255,1,1824,kimA,53.67324561403509,
1000,CDS,486431,488255,1,1824,kimA,53.67324561403509,
1001,gene,488313,488763,1,450,nudT,50.22222222222222,
1002,CDS,488313,488763,1,450,nudT,50.22222222222222,
1003,gene,488829,490554,1,1725,poxB,49.79710144927536,
1004,CDS,488829,490554,1,1725,poxB,49.79710144927536,
1006,CDS,490545,490749,-1,204,BSU_04345,68.13725490196079,
1005,gene,490545,490749,-1,204,BSU_04345,68.13725490196079,
1007,gene,490776,491043,-1,267,ydzK,57.67790262172284,
1008,CDS,490776,491043,-1,267,ydzK,57.67790262172284,
1010,CDS,491146,492424,-1,1278,mntH,51.72143974960876,
1009,gene,491146,492424,-1,1278,mntH,51.72143974960876,
1011,gene,492653,492911,-1,258,ydaS,45.73643410852713,
1012,CDS,492653,492911,-1,258,ydaS,45.73643410852713,
1014,CDS,492988,493441,-1,453,ydaT,53.20088300220751,
1013,gene,492988,493441,-1,453,ydaT,53.20088300220751,
1015,gene,493558,494377,1,819,ydbA,53.23565323565324,
1016,CDS,493558,494377,1,819,ydbA,53.23565323565324,
1018,CDS,494505,494877,1,372,gsiB,57.795698924731184,
1017,gene,494505,494877,1,372,gsiB,57.795698924731184,
1019,gene,495008,495350,1,342,ydbB,51.75438596491229,
1020,CDS,495008,495350,1,342,ydbB,51.75438596491229,
1021,gene,495343,495703,1,360,ydbC,54.72222222222223,
1022,CDS,495343,495703,1,360,ydbC,54.72222222222223,
1024,CDS,495739,496561,-1,822,ydbD,50.85158150851582,
1023,gene,495739,496561,-1,822,ydbD,50.85158150851582,
1025,gene,496645,497698,-1,1053,dctB,56.22032288698955,
1026,CDS,496645,497698,-1,1053,dctB,56.22032288698955,
1028,CDS,497767,499375,1,1608,dctS,53.420398009950254,
1027,gene,497767,499375,1,1608,dctS,53.420398009950254,
1029,gene,499364,500045,1,681,dctR,53.30396475770925,
1030,CDS,499364,500045,1,681,dctR,53.30396475770925,
1032,CDS,500165,501431,1,1266,dctP,54.02843601895735,
1031,gene,500165,501431,1,1266,dctP,54.02843601895735,
1033,gene,501578,502631,1,1053,ydbI,56.22032288698955,
1034,CDS,501578,502631,1,1053,ydbI,56.22032288698955,
1036,CDS,502907,503834,1,927,ydbJ,52.96655879180151,
1035,gene,502907,503834,1,927,ydbJ,52.96655879180151,
1037,gene,503853,504594,1,741,ydbK,58.02968960863698,
1038,CDS,503853,504594,1,741,ydbK,58.02968960863698,
1039,gene,504688,505024,1,336,ydbL,56.845238095238095,
1040,CDS,504688,505024,1,336,ydbL,56.845238095238095,
1042,CDS,505151,506297,1,1146,ydbM,49.73821989528796,
1041,gene,505151,506297,1,1146,ydbM,49.73821989528796,
1043,gene,506321,506501,-1,180,fbpB,56.666666666666664,
1044,CDS,506321,506501,-1,180,fbpB,56.666666666666664,
1046,CDS,506454,506619,-1,165,fbpA,58.18181818181818,
1045,gene,506454,506619,-1,165,fbpA,58.18181818181818,
1047,gene,506865,507738,1,873,ydbO,54.29553264604811,
1048,CDS,506865,507738,1,873,ydbO,54.29553264604811,
1049,gene,507752,508073,-1,321,ydbP,61.37071651090342,
1050,CDS,507752,508073,-1,321,ydbP,61.37071651090342,
1051,gene,508247,509312,1,1065,ddlA,53.14553990610329,
1052,CDS,508247,509312,1,1065,ddlA,53.14553990610329,
1053,gene,509383,510757,1,1374,murF,52.9839883551674,
1054,CDS,509383,510757,1,1374,murF,52.9839883551674,
1055,gene,511156,512641,1,1485,cshA,54.141414141414145,
1056,CDS,511156,512641,1,1485,cshA,54.141414141414145,
1058,CDS,512813,513293,1,480,ydbS,52.916666666666664,
1057,gene,512813,513293,1,480,ydbS,52.916666666666664,
1060,CDS,513282,514764,1,1482,ydbT,55.87044534412956,
1059,gene,513282,514764,1,1482,ydbT,55.87044534412956,
1061,gene,515015,515615,-1,600,ydcA,54.50000000000001,
1062,CDS,515015,515615,-1,600,ydcA,54.50000000000001,
1064,CDS,515709,516075,1,366,acpS,51.36612021857923,
1063,gene,515709,516075,1,366,acpS,51.36612021857923,
1065,gene,516240,517257,1,1017,ydcC,58.30875122910521,
1066,CDS,516240,517257,1,1017,ydcC,58.30875122910521,
1067,gene,517371,518541,1,1170,alrA,52.13675213675214,
1068,CDS,517371,518541,1,1170,alrA,52.13675213675214,
1069,gene,518656,518938,1,282,ndoAI,52.4822695035461,
1070,CDS,518656,518938,1,282,ndoAI,52.4822695035461,
1071,gene,518942,519293,1,351,ndoA,57.54985754985755,
1072,CDS,518942,519293,1,351,ndoA,57.54985754985755,
1073,gene,519407,520232,1,825,rsbRA,56.72727272727273,
1074,CDS,519407,520232,1,825,rsbRA,56.72727272727273,
1076,CDS,520236,520602,1,366,rsbS,55.73770491803278,
1075,gene,520236,520602,1,366,rsbS,55.73770491803278,
1077,gene,520605,521007,1,402,rsbT,51.99004975124378,
1078,CDS,520605,521007,1,402,rsbT,51.99004975124378,
1080,CDS,521018,522026,1,1008,rsbU,57.44047619047619,
1079,gene,521018,522026,1,1008,rsbU,57.44047619047619,
1081,gene,522087,522417,1,330,rsbV,58.78787878787879,
1082,CDS,522087,522417,1,330,rsbV,58.78787878787879,
1084,CDS,522413,522896,1,483,rsbW,55.6935817805383,
1083,gene,522413,522896,1,483,rsbW,55.6935817805383,
1085,gene,522861,523650,1,789,sigB,54.62610899873257,
1086,CDS,522861,523650,1,789,sigB,54.62610899873257,
1088,CDS,523649,524249,1,600,rsbX,58.166666666666664,
1087,gene,523649,524249,1,600,rsbX,58.166666666666664,
1089,gene,524359,524476,1,117,BSU_04745,58.97435897435898,
1090,CDS,524359,524476,1,117,BSU_04745,58.97435897435898,
1091,gene,524491,524785,1,294,ydcF,57.82312925170068,
1092,CDS,524491,524785,1,294,ydcF,57.82312925170068,
1094,CDS,524781,525222,1,441,ydcG,58.95691609977324,
1093,gene,524781,525222,1,441,ydcG,58.95691609977324,
1096,CDS,525205,525649,1,444,ydcH,55.63063063063063,
1095,gene,525205,525649,1,444,ydcH,55.63063063063063,
1098,CDS,525742,527902,1,2160,tex,54.25925925925926,
1097,gene,525742,527902,1,2160,tex,54.25925925925926,
1099,gene,527911,528025,-1,114,cmpA,66.66666666666666,
1100,CDS,527911,528025,-1,114,cmpA,66.66666666666666,
1102,CDS,528128,528581,1,453,ydcK,58.05739514348785,
1101,gene,528128,528581,1,453,ydcK,58.05739514348785,
1103,gene,528703,528778,1,75,trnS-Asn,44.0,
1104,tRNA,528703,528778,1,75,trnS-Asn,44.0,
1105,gene,528782,528873,1,91,trnS-Ser,39.56043956043956,
1106,tRNA,528782,528873,1,91,trnS-Ser,39.56043956043956,
1107,gene,528902,528974,1,72,trnS-Glu,38.88888888888889,
1108,tRNA,528902,528974,1,72,trnS-Glu,38.88888888888889,
1109,gene,528985,529060,1,75,trnS-Gln,44.0,
1110,tRNA,528985,529060,1,75,trnS-Gln,44.0,
1112,tRNA,529086,529162,1,76,trnS-Lys,51.31578947368421,
1111,gene,529086,529162,1,76,trnS-Lys,51.31578947368421,
1114,tRNA,529173,529255,1,82,trnS-Leu1,40.243902439024396,
1113,gene,529173,529255,1,82,trnS-Leu1,40.243902439024396,
1115,gene,529335,529422,1,87,trnS-Leu2,37.93103448275862,
1116,tRNA,529335,529422,1,87,trnS-Leu2,37.93103448275862,
1117,gene,529504,530611,-1,1107,ydcL,68.74435411020777,
1118,CDS,529504,530611,-1,1107,ydcL,68.74435411020777,
1119,gene,530623,531133,-1,510,immA,68.43137254901961,
1120,CDS,530623,531133,-1,510,immA,68.43137254901961,
1122,CDS,531129,531513,-1,384,immR,66.66666666666666,
1121,gene,531129,531513,-1,384,immR,66.66666666666666,
1123,gene,531786,531981,1,195,xis,65.12820512820512,
1124,CDS,531786,531981,1,195,xis,65.12820512820512,
1125,gene,531977,532238,1,261,ydzL,65.90038314176245,
1126,CDS,531977,532238,1,261,ydzL,65.90038314176245,
1127,gene,532291,532552,1,261,ydcO,66.28352490421456,
1128,CDS,532291,532552,1,261,ydcO,66.28352490421456,
1129,gene,532582,532642,-1,60,sncO,61.66666666666667,
1130,misc_RNA,532582,532642,-1,60,sncO,61.66666666666667,
1131,gene,532757,532886,1,129,BSU_04849,60.46511627906976,
1132,CDS,532757,532886,1,129,BSU_04849,60.46511627906976,
1133,gene,532921,533302,1,381,helP,61.417322834645674,
1134,CDS,532921,533302,1,381,helP,61.417322834645674,
1135,gene,533337,534780,1,1443,conQ,60.56826056826057,
1136,CDS,533337,534780,1,1443,conQ,60.56826056826057,
1137,gene,534772,535831,1,1059,nicK,61.37865911237016,
1138,CDS,534772,535831,1,1059,nicK,61.37865911237016,
1139,gene,536095,536365,1,270,ydcS,67.4074074074074,
1140,CDS,536095,536365,1,270,ydcS,67.4074074074074,
1141,gene,536403,536670,1,267,ydcT,63.29588014981273,
1142,CDS,536403,536670,1,267,ydcT,63.29588014981273,
1143,gene,536686,536995,1,309,yddA,64.07766990291263,
1144,CDS,536686,536995,1,309,yddA,64.07766990291263,
1145,gene,536984,538049,1,1065,conB,64.31924882629107,
1146,CDS,536984,538049,1,1065,conB,64.31924882629107,
1147,gene,538060,538309,1,249,conC,59.43775100401606,
1148,CDS,538060,538309,1,249,conC,59.43775100401606,
1149,gene,538321,538846,1,525,conD,63.23809523809524,
1150,CDS,538321,538846,1,525,conD,63.23809523809524,
1151,gene,538733,541229,1,2496,conE,60.97756410256411,
1152,CDS,538733,541229,1,2496,conE,60.97756410256411,
1153,gene,541247,541574,1,327,yddF,65.4434250764526,
1154,CDS,541247,541574,1,327,yddF,65.4434250764526,
1155,gene,541577,544025,1,2448,conG,61.47875816993464,
1156,CDS,541577,544025,1,2448,conG,61.47875816993464,
1157,gene,544021,545011,1,990,cwlT,58.686868686868685,
1158,CDS,544021,545011,1,990,cwlT,58.686868686868685,
1159,gene,545025,545532,1,507,yddI,65.68047337278107,
1160,CDS,545025,545532,1,507,yddI,65.68047337278107,
1161,gene,545594,545975,1,381,yddJ,66.40419947506561,
1162,CDS,545594,545975,1,381,yddJ,66.40419947506561,
1163,gene,546165,546966,-1,801,yddK,70.28714107365793,
1164,CDS,546165,546966,-1,801,yddK,70.28714107365793,
1165,gene,547305,548481,1,1176,rapI,69.21768707482994,
1166,CDS,547305,548481,1,1176,rapI,69.21768707482994,
1167,gene,548437,548557,1,120,phrI,64.16666666666667,
1168,CDS,548437,548557,1,120,phrI,64.16666666666667,
1169,gene,548709,549651,1,942,yddM,70.38216560509554,
1170,CDS,548709,549651,1,942,yddM,70.38216560509554,
1171,gene,550239,551259,-1,1020,yddN,61.66666666666667,
1172,CDS,550239,551259,-1,1020,yddN,61.66666666666667,
1173,gene,551518,551929,1,411,lrpA,70.31630170316302,
1174,CDS,551518,551929,1,411,lrpA,70.31630170316302,
1175,gene,552051,552501,-1,450,lrpB,68.44444444444444,
1176,CDS,552051,552501,-1,450,lrpB,68.44444444444444,
1177,gene,552615,553158,1,543,yddQ,62.430939226519335,
1178,CDS,552615,553158,1,543,yddQ,62.430939226519335,
1179,gene,553710,554475,1,765,yddR,65.359477124183,
1180,CDS,553710,554475,1,765,yddR,65.359477124183,
1181,gene,554668,555979,1,1311,yddS,59.87795575896262,
1182,CDS,554668,555979,1,1311,yddS,59.87795575896262,
1183,gene,556561,556738,1,177,ydzM,72.31638418079096,
1184,CDS,556561,556738,1,177,ydzM,72.31638418079096,
1185,gene,556762,557449,1,687,yddT,64.62882096069869,
1186,CDS,556762,557449,1,687,yddT,64.62882096069869,
1187,gene,557872,558058,1,186,ydzN,69.35483870967742,
1188,CDS,557872,558058,1,186,ydzN,69.35483870967742,
1189,gene,558407,559001,1,594,sufLC,67.84511784511784,
1190,CDS,558407,559001,1,594,sufLC,67.84511784511784,
1191,gene,559263,559464,1,201,cspC,60.19900497512438,
1192,CDS,559263,559464,1,201,cspC,60.19900497512438,
1193,gene,559531,559610,-1,79,sncZ,67.08860759493672,
1194,misc_RNA,559531,559610,-1,79,sncZ,67.08860759493672,
1195,gene,560150,560612,-1,462,cdnL,67.53246753246754,
1196,CDS,560150,560612,-1,462,cdnL,67.53246753246754,
1197,gene,561179,561416,-1,237,ydzE,62.447257383966246,
1198,CDS,561179,561416,-1,237,ydzE,62.447257383966246,
1199,gene,561513,562389,-1,876,ydeC,65.52511415525115,
1200,CDS,561513,562389,-1,876,ydeC,65.52511415525115,
1201,gene,562501,563461,1,960,ydeD,60.416666666666664,
1202,CDS,562501,563461,1,960,ydeD,60.416666666666664,
1203,gene,563613,564486,-1,873,ydeE,62.08476517754868,
1204,CDS,563613,564486,-1,873,ydeE,62.08476517754868,
1205,gene,564712,566101,1,1389,ydeF,59.10727141828653,
1206,CDS,564712,566101,1,1389,ydeF,59.10727141828653,
1207,gene,566210,567503,1,1293,ydeG,55.91647331786543,
1208,CDS,566210,567503,1,1293,ydeG,55.91647331786543,
1209,gene,567661,568108,1,447,ydeH,65.54809843400447,
1210,CDS,567661,568108,1,447,ydeH,65.54809843400447,
1211,gene,568344,568938,1,594,ydeI,63.63636363636363,
1212,CDS,568344,568938,1,594,ydeI,63.63636363636363,
1213,gene,569289,569949,-1,660,ydeJ,58.63636363636363,
1214,CDS,569289,569949,-1,660,ydeJ,58.63636363636363,
1215,gene,570370,571234,-1,864,ydeK,46.64351851851852,
1216,CDS,570370,571234,-1,864,ydeK,46.64351851851852,
1217,gene,571388,572780,1,1392,ydeL,58.189655172413794,
1218,CDS,571388,572780,1,1392,ydeL,58.189655172413794,
1219,gene,572973,573399,1,426,ydeM,65.25821596244131,
1220,CDS,572973,573399,1,426,ydeM,65.25821596244131,
1221,gene,573451,574024,-1,573,ydeN,58.46422338568935,
1222,CDS,573451,574024,-1,573,ydeN,58.46422338568935,
1223,gene,574105,574435,-1,330,ydzF,55.45454545454545,
1224,CDS,574105,574435,-1,330,ydzF,55.45454545454545,
1225,gene,574689,575562,1,873,ydeO,59.221076746849945,
1226,CDS,574689,575562,1,873,ydeO,59.221076746849945,
1227,gene,575711,576098,-1,387,ydeP,60.46511627906976,
1228,CDS,575711,576098,-1,387,ydeP,60.46511627906976,
1229,gene,576208,576802,1,594,ydeQ,57.57575757575758,
1230,CDS,576208,576802,1,594,ydeQ,57.57575757575758,
1231,gene,576945,578133,-1,1188,ydeR,53.03030303030303,
1232,CDS,576945,578133,-1,1188,ydeR,53.03030303030303,
1233,gene,578336,578933,1,597,ydeS,53.60134003350083,
1234,CDS,578336,578933,1,597,ydeS,53.60134003350083,
1235,gene,579046,579232,1,186,ydzO,65.59139784946237,
1236,CDS,579046,579232,1,186,ydzO,65.59139784946237,
1237,gene,579540,579876,1,336,aseR,62.5,
1238,CDS,579540,579876,1,336,aseR,62.5,
1239,gene,579888,581196,1,1308,arsF,59.48012232415903,
1240,CDS,579888,581196,1,1308,arsF,59.48012232415903,
1241,gene,581227,581329,1,102,ydzSn,47.05882352941176,
1242,misc_feature,581227,581329,1,102,ydzSn,47.05882352941176,
1243,gene,581340,581454,1,114,ydzSc,57.89473684210527,
1244,misc_feature,581340,581454,1,114,ydzSc,57.89473684210527,
1245,gene,581693,582479,1,786,ydfB,63.48600508905853,
1246,CDS,581693,582479,1,786,ydfB,63.48600508905853,
1247,gene,582535,583456,-1,921,ydfC,58.63192182410424,
1248,CDS,582535,583456,-1,921,ydfC,58.63192182410424,
1249,gene,583588,585037,1,1449,ydfD,59.8343685300207,
1250,CDS,583588,585037,1,1449,ydfD,59.8343685300207,
1251,gene,585154,585778,-1,624,ydfE,60.416666666666664,
1252,CDS,585154,585778,-1,624,ydfE,60.416666666666664,
1253,gene,585867,586548,1,681,ydfF,57.415565345080765,
1254,CDS,585867,586548,1,681,ydfF,57.415565345080765,
1255,gene,586627,587071,-1,444,ydfG,59.23423423423423,
1256,CDS,586627,587071,-1,444,ydfG,59.23423423423423,
1257,gene,587156,587336,-1,180,ydzP,62.22222222222222,
1258,CDS,587156,587336,-1,180,ydzP,62.22222222222222,
1259,gene,587332,587476,-1,144,ydzQ,65.27777777777779,
1260,CDS,587332,587476,-1,144,ydzQ,65.27777777777779,
1261,gene,587743,588967,1,1224,ydfH,59.31372549019608,
1262,CDS,587743,588967,1,1224,ydfH,59.31372549019608,
1263,gene,588959,589601,1,642,ydfI,60.747663551401864,
1264,CDS,588959,589601,1,642,ydfI,60.747663551401864,
1265,gene,589716,591891,1,2175,ydfJ,57.56321839080459,
1266,CDS,589716,591891,1,2175,ydfJ,57.56321839080459,
1267,gene,592302,593205,-1,903,cesA,57.36434108527132,
1268,CDS,592302,593205,-1,903,cesA,57.36434108527132,
1269,gene,593406,594096,-1,690,ydfK,58.550724637681164,
1270,CDS,593406,594096,-1,690,ydfK,58.550724637681164,
1271,gene,594185,594998,-1,813,ydfL,63.34563345633456,
1272,CDS,594185,594998,-1,813,ydfL,63.34563345633456,
1273,gene,595108,596002,-1,894,mneP,57.27069351230425,
1274,CDS,595108,596002,-1,894,mneP,57.27069351230425,
1275,gene,596477,597098,1,621,ydfN,58.132045088566834,
1276,CDS,596477,597098,1,621,ydfN,58.132045088566834,
1277,gene,597113,598052,1,939,ydfO,52.822151224707135,
1278,CDS,597113,598052,1,939,ydfO,52.822151224707135,
1279,gene,598153,598543,1,390,ydfP,55.64102564102564,
1280,CDS,598153,598543,1,390,ydfP,55.64102564102564,
1281,gene,598728,599067,1,339,ydfQ,61.35693215339233,
1282,CDS,598728,599067,1,339,ydfQ,61.35693215339233,
1283,gene,599106,599343,-1,237,ydzH,62.869198312236286,
1284,CDS,599106,599343,-1,237,ydzH,62.869198312236286,
1285,gene,599874,600105,-1,231,ydzR,58.44155844155844,
1286,CDS,599874,600105,-1,231,ydzR,58.44155844155844,
1287,gene,600228,600906,-1,678,ydfR,59.882005899705014,
1288,CDS,600228,600906,-1,678,ydfR,59.882005899705014,
1289,gene,601018,601726,1,708,ydfS,62.005649717514125,
1290,CDS,601018,601726,1,708,ydfS,62.005649717514125,
1291,gene,601740,602172,-1,432,cotP,59.95370370370371,
1292,CDS,601740,602172,-1,432,cotP,59.95370370370371,
1293,gene,602184,602427,-1,243,ydgA,60.08230452674898,
1294,CDS,602184,602427,-1,243,ydgA,60.08230452674898,
1295,gene,602440,602713,-1,273,ydgB,60.07326007326007,
1296,CDS,602440,602713,-1,273,ydgB,60.07326007326007,
1297,gene,603011,603599,1,588,ydgC,58.333333333333336,
1298,CDS,603011,603599,1,588,ydgC,58.333333333333336,
1299,gene,603595,603940,1,345,ydgD,56.811594202898554,
1300,CDS,603595,603940,1,345,ydgD,56.811594202898554,
1301,gene,604102,604576,1,474,ydgE,54.85232067510548,
1302,CDS,604102,604576,1,474,ydgE,54.85232067510548,
1303,gene,604735,606379,-1,1644,vmlR,56.02189781021898,
1304,CDS,604735,606379,-1,1644,vmlR,56.02189781021898,
1305,gene,606698,608075,-1,1377,ydgF,55.70079883805374,
1306,CDS,606698,608075,-1,1377,ydgF,55.70079883805374,
1307,gene,608245,608764,-1,519,dinB,58.1888246628131,
1308,CDS,608245,608764,-1,519,dinB,58.1888246628131,
1309,gene,608932,609391,1,459,ydgG,58.387799564270146,
1310,CDS,608932,609391,1,459,ydgG,58.387799564270146,
1311,gene,609387,612045,1,2658,ydgH,54.77802859292701,
1312,CDS,609387,612045,1,2658,ydgH,54.77802859292701,
1313,gene,612190,612820,-1,630,ydgI,54.12698412698413,
1314,CDS,612190,612820,-1,630,ydgI,54.12698412698413,
1315,gene,612835,613330,-1,495,ydgJ,54.74747474747475,
1316,CDS,612835,613330,-1,495,ydgJ,54.74747474747475,
1317,gene,613640,614849,1,1209,ydgK,52.853598014888334,
1318,CDS,613640,614849,1,1209,ydgK,52.853598014888334,
1319,gene,614884,615622,-1,738,ydhB,55.82655826558266,
1320,CDS,614884,615622,-1,738,ydhB,55.82655826558266,
1321,gene,615870,616545,1,675,ydhC,58.22222222222222,
1322,CDS,615870,616545,1,675,ydhC,58.22222222222222,
1323,gene,616671,617934,1,1263,spoL,51.78147268408551,
1324,CDS,616671,617934,1,1263,spoL,51.78147268408551,
1325,gene,618094,619282,1,1188,ydhE,56.73400673400673,
1326,CDS,618094,619282,1,1188,ydhE,56.73400673400673,
1327,gene,619320,620031,-1,711,ydhF,59.07172995780591,
1328,CDS,619320,620031,-1,711,ydhF,59.07172995780591,
1329,gene,620096,621485,-1,1389,phoB,55.72354211663067,
1330,CDS,620096,621485,-1,1389,phoB,55.72354211663067,
1331,gene,621846,622218,1,372,fra,59.40860215053764,
1332,CDS,621846,622218,1,372,fra,59.40860215053764,
1333,gene,622292,622790,-1,498,ydhH,61.44578313253012,
1334,CDS,622292,622790,-1,498,ydhH,61.44578313253012,
1335,gene,622807,623290,-1,483,ydhI,59.62732919254658,
1336,CDS,622807,623290,-1,483,ydhI,59.62732919254658,
1337,gene,623372,624350,1,978,ydhJ,57.259713701431494,
1338,CDS,623372,624350,1,978,ydhJ,57.259713701431494,
1339,gene,624491,625109,1,618,ydhK,58.252427184466015,
1340,CDS,624491,625109,1,618,ydhK,58.252427184466015,
1341,gene,625124,626291,-1,1167,pbuE,53.72750642673522,
1342,CDS,625124,626291,-1,1167,pbuE,53.72750642673522,
1343,gene,626345,626446,-1,101,aswA,70.29702970297029,
1344,misc_RNA,626345,626446,-1,101,aswA,70.29702970297029,
1345,gene,626621,626933,1,312,gmuB,57.692307692307686,
1346,CDS,626621,626933,1,312,gmuB,57.692307692307686,
1347,gene,626932,627265,1,333,gmuA,56.75675675675676,
1348,CDS,626932,627265,1,333,gmuA,56.75675675675676,
1349,gene,627283,628612,1,1329,gmuC,55.455229495861545,
1350,CDS,627283,628612,1,1329,gmuC,55.455229495861545,
1351,gene,628629,630027,1,1398,gmuD,55.29327610872675,
1352,CDS,628629,630027,1,1398,gmuD,55.29327610872675,
1353,gene,630169,630883,1,714,gmuR,59.66386554621849,
1354,CDS,630169,630883,1,714,gmuR,59.66386554621849,
1355,gene,630911,631811,1,900,gmuE,52.888888888888886,
1356,CDS,630911,631811,1,900,gmuE,52.888888888888886,
1357,gene,631807,632755,1,948,gmuF,56.540084388185655,
1358,CDS,631807,632755,1,948,gmuF,56.540084388185655,
1359,gene,632773,633862,1,1089,gmuG,57.20844811753902,
1360,CDS,632773,633862,1,1089,gmuG,57.20844811753902,
1361,gene,633922,634651,-1,729,ydhUc,55.692729766803836,
1362,misc_feature,633922,634651,-1,729,ydhUc,55.692729766803836,
1363,gene,634650,634776,-1,126,ydhUn,56.34920634920635,
1364,misc_feature,634650,634776,-1,126,ydhUn,56.34920634920635,
1365,gene,635109,635186,1,77,trnE-Arg,42.857142857142854,
1366,tRNA,635109,635186,1,77,trnE-Arg,42.857142857142854,
1367,gene,635199,635273,1,74,trnE-Gly,48.64864864864865,
1368,tRNA,635199,635273,1,74,trnE-Gly,48.64864864864865,
1369,gene,635432,636987,1,1555,rrnE-16S,45.27331189710611,
1370,rRNA,635432,636987,1,1555,rrnE-16S,45.27331189710611,
1371,gene,637154,640082,1,2928,rrnE-23S,46.10655737704918,
1372,rRNA,637154,640082,1,2928,rrnE-23S,46.10655737704918,
1373,gene,640137,640254,1,117,rrnE-5S,41.88034188034188,
1374,rRNA,640137,640254,1,117,rrnE-5S,41.88034188034188,
1375,gene,640267,640344,1,77,trnE-Met,36.36363636363637,
1376,tRNA,640267,640344,1,77,trnE-Met,36.36363636363637,
1377,gene,640404,640481,1,77,trnE-Asp,36.36363636363637,
1378,tRNA,640404,640481,1,77,trnE-Asp,36.36363636363637,
1379,gene,640661,641639,1,978,thiL,58.077709611451944,
1380,CDS,640661,641639,1,978,thiL,58.077709611451944,
1381,gene,641653,642130,1,477,tsaE,59.11949685534591,
1382,CDS,641653,642130,1,477,tsaE,59.11949685534591,
1383,gene,642110,642800,1,690,tsaB,55.65217391304348,
1384,CDS,642110,642800,1,690,tsaB,55.65217391304348,
1385,gene,642809,643265,1,456,rimI,56.14035087719298,
1386,CDS,642809,643265,1,456,rimI,56.14035087719298,
1387,gene,643257,644298,1,1041,tsaD,54.082612872238236,
1388,CDS,643257,644298,1,1041,tsaD,54.082612872238236,
1389,gene,644527,646456,-1,1929,ydiF,56.7651632970451,
1390,CDS,644527,646456,-1,1929,ydiF,56.7651632970451,
1391,gene,646581,647094,1,513,moaC,55.165692007797276,
1392,CDS,646581,647094,1,513,moaC,55.165692007797276,
1393,gene,647090,647738,1,648,rex,58.79629629629629,
1394,CDS,647090,647738,1,648,rex,58.79629629629629,
1395,gene,647759,647933,1,174,tatAY,56.32183908045977,
1396,CDS,647759,647933,1,174,tatAY,56.32183908045977,
1397,gene,647939,648704,1,765,tatCY,56.99346405228758,
1398,CDS,647939,648704,1,765,tatCY,56.99346405228758,
1399,gene,648741,648933,-1,192,ydiK,57.8125,
1400,CDS,648741,648933,-1,192,ydiK,57.8125,
1401,gene,648929,649664,-1,735,ydiL,59.183673469387756,
1402,CDS,648929,649664,-1,735,ydiL,59.183673469387756,
1403,gene,649902,650187,1,285,groES,56.49122807017544,
1404,CDS,649902,650187,1,285,groES,56.49122807017544,
1405,gene,650233,651868,1,1635,groEL,52.66055045871559,
1406,CDS,650233,651868,1,1635,groEL,52.66055045871559,
1407,gene,651976,652084,-1,108,ydzTc,59.25925925925925,
1408,misc_feature,651976,652084,-1,108,ydzTc,59.25925925925925,
1409,gene,652086,652245,-1,159,ydzT,60.37735849056604,
1410,misc_feature,652086,652245,-1,159,ydzT,60.37735849056604,
1411,gene,652289,652418,-1,129,ydzT,64.34108527131784,
1412,misc_feature,652289,652418,-1,129,ydzT,64.34108527131784,
1413,gene,652510,652720,-1,210,ydzT,59.04761904761905,
1414,misc_feature,652510,652720,-1,210,ydzT,59.04761904761905,
1415,gene,652712,653018,-1,306,ydzTn,61.111111111111114,
1416,misc_feature,652712,653018,-1,306,ydzTn,61.111111111111114,
1417,gene,653431,653812,1,381,ydiM,60.367454068241464,
1418,CDS,653431,653812,1,381,ydiM,60.367454068241464,
1419,gene,654070,654343,1,273,ydzU,65.56776556776556,
1420,CDS,654070,654343,1,273,ydzU,65.56776556776556,
1421,gene,654332,654692,1,360,ydzV,60.27777777777777,
1422,misc_feature,654332,654692,1,360,ydzV,60.27777777777777,
1423,gene,654977,655193,1,216,ydiN,69.44444444444444,
1424,misc_feature,654977,655193,1,216,ydiN,69.44444444444444,
1425,gene,655222,656506,1,1284,bsuMA,64.09657320872275,
1426,CDS,655222,656506,1,1284,bsuMA,64.09657320872275,
1427,gene,656527,657697,1,1170,bsuMB,60.85470085470085,
1428,CDS,656527,657697,1,1170,bsuMB,60.85470085470085,
1429,gene,657792,658062,-1,270,ydzWc,54.44444444444444,
1430,misc_feature,657792,658062,-1,270,ydzWc,54.44444444444444,
1431,gene,658060,658189,-1,129,ydzWmc,54.263565891472865,
1432,misc_feature,658060,658189,-1,129,ydzWmc,54.263565891472865,
1433,gene,658188,658605,-1,417,ydzWmb,58.752997601918466,
1434,misc_feature,658188,658605,-1,417,ydzWmb,58.752997601918466,
1435,gene,658614,658758,-1,144,ydzW,47.91666666666667,
1436,misc_feature,658614,658758,-1,144,ydzW,47.91666666666667,
1437,gene,658812,659010,-1,198,ydzW,55.55555555555556,
1438,misc_feature,658812,659010,-1,198,ydzW,55.55555555555556,
1439,gene,659009,659129,-1,120,ydzWma,52.5,
1440,misc_feature,659009,659129,-1,120,ydzWma,52.5,
1441,gene,659128,659221,-1,93,ydzWn,53.76344086021505,
1442,misc_feature,659128,659221,-1,93,ydzWn,53.76344086021505,
1443,gene,659622,660564,1,942,bsuRA,63.481953290870486,
1444,CDS,659622,660564,1,942,bsuRA,63.481953290870486,
1445,gene,660595,661627,1,1032,bsuRB,66.86046511627907,
1446,CDS,660595,661627,1,1032,bsuRB,66.86046511627907,
1447,gene,661629,663027,1,1398,bsuRC,69.5994277539342,
1448,CDS,661629,663027,1,1398,bsuRC,69.5994277539342,
1449,gene,663600,663936,1,336,ydjB,66.66666666666666,
1450,CDS,663600,663936,1,336,ydjB,66.66666666666666,
1451,gene,664318,664669,1,351,ydjC,64.1025641025641,
1452,CDS,664318,664669,1,351,ydjC,64.1025641025641,
1453,gene,664774,667264,-1,2490,gutR,53.45381526104418,
1454,CDS,664774,667264,-1,2490,gutR,53.45381526104418,
1455,gene,667465,668527,1,1062,gutB,52.824858757062145,
1456,CDS,667465,668527,1,1062,gutB,52.824858757062145,
1457,gene,668600,669992,1,1392,gutP,57.543103448275865,
1458,CDS,668600,669992,1,1392,gutP,57.543103448275865,
1459,gene,670086,671049,1,963,ydjE,54.20560747663551,
1460,CDS,670086,671049,1,963,ydjE,54.20560747663551,
1461,gene,671244,671928,1,684,pspA,56.72514619883041,
1462,CDS,671244,671928,1,684,pspA,56.72514619883041,
1463,gene,671993,673019,1,1026,ydjG,56.4327485380117,
1464,CDS,671993,673019,1,1026,ydjG,56.4327485380117,
1465,gene,673018,673783,1,765,ydjH,57.385620915032675,
1466,CDS,673018,673783,1,765,ydjH,57.385620915032675,
1467,gene,673813,674785,1,972,ydjI,57.818930041152264,
1468,CDS,673813,674785,1,972,ydjI,57.818930041152264,
1469,gene,674831,675857,-1,1026,ydjJ,54.97076023391813,
1470,CDS,674831,675857,-1,1026,ydjJ,54.97076023391813,
1471,gene,676441,677863,1,1422,iolT,54.14908579465541,
1472,CDS,676441,677863,1,1422,iolT,54.14908579465541,
1473,gene,677910,678951,-1,1041,bdhA,52.44956772334294,
1474,CDS,677910,678951,-1,1041,bdhA,52.44956772334294,
1475,gene,679389,679761,1,372,walM,60.215053763440864,
1476,CDS,679389,679761,1,372,walM,60.215053763440864,protein involved in cell wall metabolism
1477,gene,679826,680873,1,1047,ydjN,60.3629417382999,
1478,CDS,679826,680873,1,1047,ydjN,60.3629417382999,
1479,gene,680906,681065,-1,159,ydzJ,61.0062893081761,
1480,CDS,680906,681065,-1,159,ydzJ,61.0062893081761,
1481,gene,681254,681464,-1,210,ydjO,55.714285714285715,
1482,CDS,681254,681464,-1,210,ydjO,55.714285714285715,
1483,gene,681546,682362,-1,816,ydjP,53.431372549019606,
1484,CDS,681546,682362,-1,816,ydjP,53.431372549019606,
1485,gene,682374,683364,-1,990,yeaA,59.79797979797979,
1486,CDS,682374,683364,-1,990,yeaA,59.79797979797979,
1487,gene,683461,685003,-1,1542,cotA,52.14007782101168,
1488,CDS,683461,685003,-1,1542,cotA,52.14007782101168,
1489,gene,685154,686564,-1,1410,gabP,53.12056737588653,
1490,CDS,685154,686564,-1,1410,gabP,53.12056737588653,
1491,gene,686601,686889,-1,288,ydzX,65.27777777777779,
1492,CDS,686601,686889,-1,288,ydzX,65.27777777777779,
1493,gene,686961,687834,1,873,mneS,54.63917525773196,
1494,CDS,686961,687834,1,873,mneS,54.63917525773196,
1495,gene,688183,689146,1,963,yeaC,51.71339563862928,
1496,CDS,688183,689146,1,963,yeaC,51.71339563862928,
1497,gene,689145,690342,1,1197,yeaD,51.96324143692564,
1498,CDS,689145,690342,1,1197,yeaD,51.96324143692564,
1499,gene,690363,692577,1,2214,yebA,55.103884372177056,
1500,CDS,690363,692577,1,2214,yebA,55.103884372177056,
1501,gene,692739,694281,1,1542,guaA,53.95590142671855,
1502,CDS,692739,694281,1,1542,guaA,53.95590142671855,
1503,gene,694424,694527,1,103,gswC,61.165048543689316,
1504,misc_RNA,694424,694527,1,103,gswC,61.165048543689316,
1505,gene,694661,695984,1,1323,pbuG,53.74149659863946,
1506,CDS,694661,695984,1,1323,pbuG,53.74149659863946,
1507,gene,696194,696998,1,804,yebC,56.840796019900495,
1508,CDS,696194,696998,1,804,yebC,56.840796019900495,
1509,gene,697156,697324,1,168,yebD,60.71428571428571,
1510,CDS,697156,697324,1,168,yebD,60.71428571428571,
1511,gene,697537,698092,1,555,yebE,56.75675675675676,
1512,CDS,697537,698092,1,555,yebE,56.75675675675676,
1513,gene,698091,698289,1,198,yebG,60.1010101010101,
1514,CDS,698091,698289,1,198,yebG,60.1010101010101,
1515,gene,698368,698471,1,103,gswD,58.252427184466015,
1516,misc_RNA,698368,698471,1,103,gswD,58.252427184466015,
1517,gene,698611,699100,1,489,purE,49.897750511247445,
1518,CDS,698611,699100,1,489,purE,49.897750511247445,
1519,gene,699092,700235,1,1143,purK,52.58092738407699,
1520,CDS,699092,700235,1,1143,purK,52.58092738407699,
1521,gene,700231,701527,1,1296,purB,54.39814814814815,
1522,CDS,700231,701527,1,1296,purB,54.39814814814815,
1523,gene,701600,702326,1,726,purC,57.57575757575758,
1524,CDS,701600,702326,1,726,purC,57.57575757575758,
1525,gene,702318,702573,1,255,purS,58.82352941176471,
1526,CDS,702318,702573,1,255,purS,58.82352941176471,
1527,gene,702569,703253,1,684,purQ,52.77777777777778,
1528,CDS,702569,703253,1,684,purQ,52.77777777777778,
1529,gene,703236,705465,1,2229,purL,51.81695827725438,
1530,CDS,703236,705465,1,2229,purL,51.81695827725438,
1531,gene,705440,706871,1,1431,purF,50.24458420684835,
1532,CDS,705440,706871,1,1431,purF,50.24458420684835,
1533,gene,706972,708013,1,1041,purM,50.91258405379443,
1534,CDS,706972,708013,1,1041,purM,50.91258405379443,
1535,gene,708009,708597,1,588,purN,52.721088435374156,
1536,CDS,708009,708597,1,588,purN,52.721088435374156,
1537,gene,708593,710132,1,1539,purH,51.98180636777128,
1538,CDS,708593,710132,1,1539,purH,51.98180636777128,
1539,gene,710147,711416,1,1269,purD,50.74862096138691,
1540,CDS,710147,711416,1,1269,purD,50.74862096138691,
1541,gene,711455,711875,-1,420,yezC,50.0,
1542,CDS,711455,711875,-1,420,yezC,50.0,
1543,gene,712018,713293,1,1275,yecA,51.37254901960784,
1544,CDS,712018,713293,1,1275,yecA,51.37254901960784,
1545,gene,713307,713535,-1,228,yezF,54.385964912280706,
1546,CDS,713307,713535,-1,228,yezF,54.385964912280706,
1547,gene,713663,715406,1,1743,yerA,55.47905909351692,
1548,CDS,713663,715406,1,1743,yerA,55.47905909351692,
1549,gene,715432,716428,1,996,yerB,54.317269076305216,
1550,CDS,715432,716428,1,996,yerB,54.317269076305216,
1551,gene,716430,716745,1,315,yerC,54.920634920634924,
1552,CDS,716430,716745,1,315,yerC,54.920634920634924,
1553,gene,716779,718357,-1,1578,yerD,52.59822560202788,
1554,CDS,716779,718357,-1,1578,yerD,52.59822560202788,
1555,gene,718621,719308,1,687,pcrB,51.52838427947598,
1556,CDS,718621,719308,1,687,pcrB,51.52838427947598,
1557,gene,719369,721589,1,2220,pcrA,52.2972972972973,
1558,CDS,719369,721589,1,2220,pcrA,52.2972972972973,
1559,gene,721612,723619,1,2007,ligA,50.2740408570005,
1560,CDS,721612,723619,1,2007,ligA,50.2740408570005,
1561,gene,723634,724825,1,1191,yerH,55.331654072208224,
1562,CDS,723634,724825,1,1191,yerH,55.331654072208224,
1563,gene,724986,725997,1,1011,yerI,56.775469831849655,
1564,CDS,724986,725997,1,1011,yerI,56.775469831849655,
1565,gene,726034,726733,-1,699,sapB,53.648068669527895,
1566,CDS,726034,726733,-1,699,sapB,53.648068669527895,
1567,gene,726839,728318,-1,1479,opuE,53.88776200135227,
1568,CDS,726839,728318,-1,1479,opuE,53.88776200135227,
1569,gene,728731,729022,1,291,gatC,57.73195876288659,
1570,CDS,728731,729022,1,291,gatC,57.73195876288659,
1571,gene,729037,730495,1,1458,gatA,52.46913580246913,
1572,CDS,729037,730495,1,1458,gatA,52.46913580246913,
1573,gene,730508,731939,1,1431,gatB,53.319357092942,
1574,CDS,730508,731939,1,1431,gatB,53.319357092942,
1575,gene,731953,732823,-1,870,yerO,58.04597701149425,
1576,CDS,731953,732823,-1,870,yerO,58.04597701149425,
1577,gene,732954,736113,1,3159,srfP,53.561253561253565,
1578,CDS,732954,736113,1,3159,srfP,53.561253561253565,
1579,gene,736435,737347,1,912,dagK,48.79385964912281,
1580,CDS,736435,737347,1,912,dagK,48.79385964912281,
1581,gene,737602,738982,1,1380,rlmCD,49.42028985507246,
1582,CDS,737602,738982,1,1380,rlmCD,49.42028985507246,
1583,gene,738994,739897,-1,903,yefB,68.54928017718716,
1584,CDS,738994,739897,-1,903,yefB,68.54928017718716,
1585,gene,739877,740213,1,336,yefC,64.28571428571429,
1586,CDS,739877,740213,1,336,yefC,64.28571428571429,
1587,gene,740287,742927,1,2640,yeeA,66.43939393939394,
1588,CDS,740287,742927,1,2640,yeeA,66.43939393939394,
1589,gene,742938,744738,1,1800,yeeB,66.38888888888889,
1590,CDS,742938,744738,1,1800,yeeB,66.38888888888889,
1591,gene,744850,745999,1,1149,yeeC,67.01479547432551,
1592,CDS,744850,745999,1,1149,yeeC,67.01479547432551,
1593,gene,746260,746566,-1,306,yeeD,68.95424836601308,
1594,CDS,746260,746566,-1,306,yeeD,68.95424836601308,
1595,gene,746632,746839,-1,207,yezA,67.6328502415459,
1596,CDS,746632,746839,-1,207,yezA,67.6328502415459,
1597,gene,747078,747534,-1,456,yezG,68.85964912280701,
1598,CDS,747078,747534,-1,456,yezG,68.85964912280701,
1599,gene,747553,749563,-1,2010,yeeF,53.78109452736318,
1600,CDS,747553,749563,-1,2010,yeeF,53.78109452736318,
1601,gene,749774,750797,1,1023,yeeG,58.35777126099707,
1602,CDS,749774,750797,1,1023,yeeG,58.35777126099707,
1603,gene,750958,752089,1,1131,rapH,58.17860300618921,
1604,CDS,750958,752089,1,1131,rapH,58.17860300618921,
1605,gene,752078,752252,1,174,phrH,58.620689655172406,
1606,CDS,752078,752252,1,174,phrH,58.620689655172406,
1607,gene,752411,753131,1,720,yeeI,50.83333333333333,
1608,CDS,752411,753131,1,720,yeeI,50.83333333333333,
1609,gene,753264,753702,1,438,cotK,49.54337899543379,
1610,CDS,753264,753702,1,438,cotK,49.54337899543379,
1611,gene,753816,754401,1,585,yezE,53.333333333333336,
1612,CDS,753816,754401,1,585,yezE,53.333333333333336,
1613,gene,754479,754923,1,444,yesE,57.20720720720721,
1614,CDS,754479,754923,1,444,yesE,57.20720720720721,
1615,gene,754919,755780,1,861,yesF,48.08362369337979,
1616,CDS,754919,755780,1,861,yesF,48.08362369337979,
1617,gene,755906,756155,1,249,cotJA,53.01204819277109,
1618,CDS,755906,756155,1,249,cotJA,53.01204819277109,
1619,gene,756138,756402,1,264,cotJB,54.54545454545454,
1620,CDS,756138,756402,1,264,cotJB,54.54545454545454,
1621,gene,756416,756986,1,570,cotJC,51.2280701754386,
1622,CDS,756416,756986,1,570,cotJC,51.2280701754386,
1623,gene,757110,757653,1,543,yesJ,48.25046040515654,
1624,CDS,757110,757653,1,543,yesJ,48.25046040515654,
1625,gene,757675,757978,1,303,yesK,50.165016501650165,
1626,CDS,757675,757978,1,303,yesK,50.165016501650165,
1627,gene,758092,758722,1,630,yesL,51.746031746031754,
1628,CDS,758092,758722,1,630,yesL,51.746031746031754,
1629,gene,758718,760452,1,1734,yesM,53.34486735870819,
1630,CDS,758718,760452,1,1734,yesM,53.34486735870819,
1631,gene,760451,761558,1,1107,yesN,50.316169828364956,
1632,CDS,760451,761558,1,1107,yesN,50.316169828364956,
1633,gene,761661,762945,1,1284,yesO,53.0373831775701,
1634,CDS,761661,762945,1,1284,yesO,53.0373831775701,
1635,gene,762941,763871,1,930,rhgP,52.25806451612903,
1636,CDS,762941,763871,1,930,rhgP,52.25806451612903,
1637,gene,763874,764765,1,891,rhgQ,52.18855218855219,
1638,CDS,763874,764765,1,891,rhgQ,52.18855218855219,
1639,gene,764780,765815,1,1035,rhgH,48.01932367149758,
1640,CDS,764780,765815,1,1035,rhgH,48.01932367149758,
1641,gene,765837,768123,1,2286,rhgR,51.88101487314086,
1642,CDS,765837,768123,1,2286,rhgR,51.88101487314086,
1643,gene,768136,768835,1,699,rhgT,48.21173104434907,
1644,CDS,768136,768835,1,699,rhgT,48.21173104434907,
1645,gene,768827,769490,1,663,yesU,48.86877828054298,
1646,CDS,768827,769490,1,663,yesU,48.86877828054298,
1647,gene,769486,770113,1,627,yesV,51.515151515151516,
1648,CDS,769486,770113,1,627,yesV,51.515151515151516,
1649,gene,770233,772096,1,1863,rhgW,47.235641438539986,
1650,CDS,770233,772096,1,1863,rhgW,47.235641438539986,
1651,gene,772141,773980,1,1839,rhgX,46.166394779771615,
1652,CDS,772141,773980,1,1839,rhgX,46.166394779771615,
1653,gene,774137,774791,1,654,yesY,52.752293577981646,
1654,CDS,774137,774791,1,654,yesY,52.752293577981646,
1655,gene,774798,776790,1,1992,rhgZ,47.28915662650602,
1656,CDS,774798,776790,1,1992,rhgZ,47.28915662650602,
1657,gene,776833,779407,1,2574,yetA,49.106449106449105,
1658,CDS,776833,779407,1,2574,yetA,49.106449106449105,
1659,gene,779528,781037,1,1509,lplA,53.943008614976804,
1660,CDS,779528,781037,1,1509,lplA,53.943008614976804,
1661,gene,781091,782048,1,957,lplB,54.649947753396034,
1662,CDS,781091,782048,1,957,lplB,54.649947753396034,
1663,gene,782061,782949,1,888,lplC,51.91441441441441,
1664,CDS,782061,782949,1,888,lplC,51.91441441441441,
1665,gene,782957,784298,1,1341,lplD,50.484712900820284,
1666,CDS,782957,784298,1,1341,lplD,50.484712900820284,
1667,gene,784380,785076,1,696,yetF,61.06321839080459,
1668,CDS,784380,785076,1,696,yetF,61.06321839080459,
1669,gene,785112,785439,-1,327,hmoA,57.798165137614674,
1670,CDS,785112,785439,-1,327,hmoA,57.798165137614674,
1671,gene,785542,785905,-1,363,yetH,56.19834710743802,
1672,CDS,785542,785905,-1,363,yetH,56.19834710743802,
1673,gene,786688,787264,1,576,yetI,57.291666666666664,
1674,misc_feature,786688,787264,1,576,yetI,57.291666666666664,
1675,gene,787263,787560,1,297,yetI,55.55555555555556,
1676,misc_feature,787263,787560,1,297,yetI,55.55555555555556,
1677,gene,787714,787882,1,168,yezD,61.904761904761905,
1678,CDS,787714,787882,1,168,yezD,61.904761904761905,
1679,gene,787991,788636,1,645,calJ,52.86821705426357,
1680,CDS,787991,788636,1,645,calJ,52.86821705426357,
1681,gene,788635,789628,1,993,yetK,52.769385699899296,
1682,CDS,788635,789628,1,993,yetK,52.769385699899296,
1683,gene,789651,790155,-1,504,flvL,56.74603174603175,
1684,CDS,789651,790155,-1,504,flvL,56.74603174603175,
1685,gene,790317,791427,1,1110,flvM,49.63963963963964,
1686,CDS,790317,791427,1,1110,flvM,49.63963963963964,
1687,gene,791461,792532,-1,1071,yetN,51.26050420168067,
1688,CDS,791461,792532,-1,1071,yetN,51.26050420168067,
1689,gene,792681,795867,1,3186,cypD,49.18392969240427,
1690,CDS,792681,795867,1,3186,cypD,49.18392969240427,
1691,gene,796313,798233,1,1920,ltaSA,58.229166666666664,
1692,CDS,796313,798233,1,1920,ltaSA,58.229166666666664,
1693,gene,798468,799233,1,765,spmH,54.509803921568626,
1694,CDS,798468,799233,1,765,spmH,54.509803921568626,
1695,gene,799239,800208,1,969,spmG,53.66357069143447,
1696,CDS,799239,800208,1,969,spmG,53.66357069143447,
1697,gene,800231,801143,1,912,yfnF,54.385964912280706,
1698,CDS,800231,801143,1,912,yfnF,54.385964912280706,
1699,gene,801171,802350,1,1179,yfnE,55.04664970313825,
1700,CDS,801171,802350,1,1179,yfnE,55.04664970313825,
1701,gene,802350,803286,1,936,yfnD,56.51709401709402,
1702,CDS,802350,803286,1,936,yfnD,56.51709401709402,
1703,gene,803316,804546,-1,1230,yfnC,47.235772357723576,
1704,CDS,803316,804546,-1,1230,yfnC,47.235772357723576,
1705,gene,804656,805364,-1,708,pynN,56.779661016949156,
1706,CDS,804656,805364,-1,708,pynN,56.779661016949156,
1707,gene,805455,806841,-1,1386,mtrA,50.86580086580087,
1708,CDS,805455,806841,-1,1386,mtrA,50.86580086580087,
1709,gene,807090,808548,1,1458,vdhT,52.19478737997256,
1710,CDS,807090,808548,1,1458,vdhT,52.19478737997256,
1711,gene,808561,809422,1,861,yfmS,51.56794425087108,
1712,CDS,808561,809422,1,861,yfmS,51.56794425087108,
1713,gene,809556,811446,1,1890,ettA,51.32275132275132,
1714,CDS,809556,811446,1,1890,ettA,51.32275132275132,
1715,gene,811568,812015,1,447,yfmQ,55.70469798657718,
1716,CDS,811568,812015,1,447,yfmQ,55.70469798657718,
1717,gene,812139,812562,1,423,copP,53.191489361702125,
1718,CDS,812139,812562,1,423,copP,53.191489361702125,
1719,gene,812627,813818,1,1191,copO,49.79009235936188,
1720,CDS,812627,813818,1,1191,copO,49.79009235936188,
1721,gene,814108,814264,1,156,yfmN,57.692307692307686,
1722,CDS,814108,814264,1,156,yfmN,57.692307692307686,
1723,gene,814383,815940,-1,1557,ettM,51.76621708413616,
1724,CDS,814383,815940,-1,1557,ettM,51.76621708413616,
1725,gene,816112,817243,1,1131,yfmL,50.75154730327144,
1726,CDS,816112,817243,1,1131,yfmL,50.75154730327144,
1727,gene,817310,817757,1,447,yfmK,55.70469798657718,
1728,CDS,817310,817757,1,447,yfmK,55.70469798657718,
1729,gene,817809,818829,-1,1020,yfmJ,51.37254901960784,
1730,CDS,817809,818829,-1,1020,yfmJ,51.37254901960784,
1731,gene,819310,820531,-1,1221,yfmI,69.36936936936937,
1732,CDS,819310,820531,-1,1221,yfmI,69.36936936936937,
1733,gene,820866,822330,1,1464,yfmG,67.34972677595628,
1734,CDS,820866,822330,1,1464,yfmG,67.34972677595628,
1735,gene,822902,823703,-1,801,fecF,50.936329588014985,
1736,CDS,822902,823703,-1,801,fecF,50.936329588014985,
1737,gene,823715,824717,-1,1002,fecE,50.69860279441117,
1738,CDS,823715,824717,-1,1002,fecE,50.69860279441117,
1739,gene,824713,825715,-1,1002,fecD,50.898203592814376,
1740,CDS,824713,825715,-1,1002,fecD,50.898203592814376,
1741,gene,825786,826734,-1,948,fecC,56.32911392405063,
1742,CDS,825786,826734,-1,948,fecC,56.32911392405063,
1743,gene,826842,827211,-1,369,yfmB,59.34959349593496,
1744,CDS,826842,827211,-1,369,yfmB,59.34959349593496,
1745,gene,827454,827802,1,348,yflT,57.758620689655174,
1746,CDS,827454,827802,1,348,yflT,57.758620689655174,
1747,gene,827992,829255,1,1263,pelA,53.60253365003958,
1748,CDS,827992,829255,1,1263,pelA,53.60253365003958,
1749,gene,829381,830818,1,1437,maeS,54.00139178844816,
1750,CDS,829381,830818,1,1437,maeS,54.00139178844816,
1751,gene,830944,832573,1,1629,citS,52.424800491098836,
1752,CDS,830944,832573,1,1629,citS,52.424800491098836,
1753,gene,832544,833225,1,681,citT,51.98237885462555,
1754,CDS,832544,833225,1,681,citT,51.98237885462555,
1755,gene,833227,834187,1,960,yflP,53.125,
1756,CDS,833227,834187,1,960,yflP,53.125,
1757,gene,834382,835684,1,1302,citM,51.843317972350235,
1758,CDS,834382,835684,1,1302,citM,51.843317972350235,
1759,gene,835739,836534,1,795,yflN,48.80503144654088,
1760,CDS,835739,836534,1,795,yflN,48.80503144654088,
1761,gene,836652,837744,1,1092,nosA,50.18315018315018,
1762,CDS,836652,837744,1,1092,nosA,50.18315018315018,
1763,gene,837734,838010,-1,276,acyP,51.81159420289855,
1764,CDS,837734,838010,-1,276,acyP,51.81159420289855,
1765,gene,838076,838742,1,666,yflK,49.0990990990991,
1766,CDS,838076,838742,1,666,yflK,49.0990990990991,
1767,gene,838782,838920,-1,138,yflJ,60.86956521739131,
1768,CDS,838782,838920,-1,138,yflJ,60.86956521739131,
1769,gene,839076,839232,-1,156,yflI,62.82051282051282,
1770,CDS,839076,839232,-1,156,yflI,62.82051282051282,
1771,gene,839338,839653,-1,315,yflH,58.41269841269842,
1772,CDS,839338,839653,-1,315,yflH,58.41269841269842,
1773,gene,839734,840484,-1,750,mapB,51.866666666666674,
1774,CDS,839734,840484,-1,750,mapB,51.866666666666674,
1775,gene,840655,842014,1,1359,nagP,52.75938189845475,
1776,CDS,840655,842014,1,1359,nagP,52.75938189845475,
1777,gene,842046,843996,-1,1950,ltaSB,57.8974358974359,
1778,CDS,842046,843996,-1,1950,ltaSB,57.8974358974359,
1779,gene,844096,844234,1,138,yflD,67.3913043478261,
1780,CDS,844096,844234,1,138,yflD,67.3913043478261,
1781,gene,844252,844645,1,393,yflB,54.70737913486005,
1782,CDS,844252,844645,1,393,yflB,54.70737913486005,
1783,gene,844769,846185,1,1416,yflA,53.24858757062147,
1784,CDS,844769,846185,1,1416,yflA,53.24858757062147,
1785,gene,846181,847258,-1,1077,yfkT,57.938718662952645,
1786,CDS,846181,847258,-1,1077,yfkT,57.938718662952645,
1787,gene,847281,847482,-1,201,yfkS,58.70646766169154,
1788,CDS,847281,847482,-1,201,yfkS,58.70646766169154,
1789,gene,847497,848652,-1,1155,yfkR,54.1991341991342,
1790,CDS,847497,848652,-1,1155,yfkR,54.1991341991342,
1791,gene,848632,850174,-1,1542,yfkQ,55.252918287937746,
1792,CDS,848632,850174,-1,1542,yfkQ,55.252918287937746,
1793,gene,850366,851779,1,1413,treP,51.66312809624911,
1794,CDS,850366,851779,1,1413,treP,51.66312809624911,
1795,gene,851849,853535,1,1686,treA,54.03321470937129,
1796,CDS,851849,853535,1,1686,treA,54.03321470937129,
1797,gene,853555,854272,1,717,treR,53.417015341701536,
1798,CDS,853555,854272,1,717,treR,53.417015341701536,
1799,gene,854411,855077,1,666,hypO,55.55555555555556,
1800,CDS,854411,855077,1,666,hypO,55.55555555555556,
1801,gene,855113,859502,-1,4389,yfkN,53.110047846889955,
1802,CDS,855113,859502,-1,4389,yfkN,53.110047846889955,
1803,gene,859744,860263,1,519,sufLB,52.98651252408478,
1804,CDS,859744,860263,1,519,sufLB,52.98651252408478,
1805,gene,860302,861493,-1,1191,yfkL,54.827875734676745,
1806,CDS,860302,861493,-1,1191,yfkL,54.827875734676745,
1807,gene,861585,861801,-1,216,yfkK,58.79629629629629,
1808,CDS,861585,861801,-1,216,yfkK,58.79629629629629,
1809,gene,862003,862474,1,471,yfkJ,53.07855626326964,
1810,CDS,862003,862474,1,471,yfkJ,53.07855626326964,
1811,gene,862491,862812,1,321,yfkI,53.58255451713395,
1812,CDS,862491,862812,1,321,yfkI,53.58255451713395,
1813,gene,862835,863663,1,828,rbn,54.347826086956516,
1814,CDS,862835,863663,1,828,rbn,54.347826086956516,
1815,gene,863861,865037,-1,1176,yfkF,50.425170068027214,
1816,CDS,863861,865037,-1,1176,yfkF,50.425170068027214,
1817,gene,865204,866260,1,1056,chaA,52.083333333333336,
1818,CDS,865204,866260,1,1056,chaA,52.083333333333336,
1819,gene,866330,867125,1,795,yfkD,55.84905660377358,
1820,CDS,866330,867125,1,795,yfkD,55.84905660377358,
1821,gene,867163,868006,-1,843,mscC,54.804270462633454,
1822,CDS,867163,868006,-1,843,mscC,54.804270462633454,
1823,gene,868006,869128,-1,1122,yfkA,51.247771836007125,
1824,CDS,868006,869128,-1,1122,yfkA,51.247771836007125,
1825,gene,869272,869458,1,186,yfjT,61.82795698924731,
1826,CDS,869272,869458,1,186,yfjT,61.82795698924731,
1827,gene,869558,870350,1,792,pdaA,55.3030303030303,
1828,CDS,869558,870350,1,792,pdaA,55.3030303030303,
1829,gene,870387,871248,-1,861,yfjR,50.174216027874564,
1830,CDS,870387,871248,-1,861,yfjR,50.174216027874564,
1831,gene,871346,872306,-1,960,yfjQ,56.14583333333333,
1832,CDS,871346,872306,-1,960,yfjQ,56.14583333333333,
1833,gene,872424,873288,1,864,yfjP,50.69444444444444,
1834,CDS,872424,873288,1,864,yfjP,50.69444444444444,
1835,gene,873401,874802,1,1401,yfjO,50.32119914346895,
1836,CDS,873401,874802,1,1401,yfjO,50.32119914346895,
1837,gene,875427,875694,1,267,yfzA,71.91011235955057,
1838,CDS,875427,875694,1,267,yfzA,71.91011235955057,
1839,gene,876425,877403,1,978,dusC,54.49897750511248,
1840,CDS,876425,877403,1,978,dusC,54.49897750511248,
1841,gene,877598,878051,1,453,yfjM,49.668874172185426,
1842,CDS,877598,878051,1,453,yfjM,49.668874172185426,
1843,gene,878080,878770,1,690,yfjL,59.42028985507246,
1844,CDS,878080,878770,1,690,yfjL,59.42028985507246,
1845,gene,879001,880003,1,1002,acoA,52.39520958083832,
1846,CDS,879001,880003,1,1002,acoA,52.39520958083832,
1847,gene,880006,881035,1,1029,acoB,49.56268221574344,
1848,CDS,880006,881035,1,1029,acoB,49.56268221574344,
1849,gene,881048,882245,1,1197,acoC,50.54302422723475,
1850,CDS,881048,882245,1,1197,acoC,50.54302422723475,
1851,gene,882265,883642,1,1377,acoL,48.5838779956427,
1852,CDS,882265,883642,1,1377,acoL,48.5838779956427,
1853,gene,883757,885575,1,1818,acoR,50.22002200220022,
1854,CDS,883757,885575,1,1818,acoR,50.22002200220022,
1855,gene,885628,885808,1,180,sspH,60.55555555555555,
1856,CDS,885628,885808,1,180,sspH,60.55555555555555,
1857,gene,885843,886173,-1,330,yfjF,48.18181818181818,
1858,CDS,885843,886173,-1,330,yfjF,48.18181818181818,
1859,gene,886222,886681,-1,459,yfjE,56.42701525054466,
1860,CDS,886222,886681,-1,459,yfjE,56.42701525054466,
1861,gene,886774,887332,-1,558,yfjD,60.39426523297491,
1862,CDS,886774,887332,-1,558,yfjD,60.39426523297491,
1863,gene,887363,888131,-1,768,yfjC,57.942708333333336,
1864,CDS,887363,888131,-1,768,yfjC,57.942708333333336,
1865,gene,888142,889366,-1,1224,yfjB,54.738562091503276,
1866,CDS,888142,889366,-1,1224,yfjB,54.738562091503276,
1867,gene,889371,889686,-1,315,yfjA,52.6984126984127,
1868,CDS,889371,889686,-1,315,yfjA,52.6984126984127,
1869,gene,890021,891371,1,1350,malA,52.0,
1870,CDS,890021,891371,1,1350,malA,52.0,
1871,gene,891435,892200,1,765,malR,58.30065359477125,
1872,CDS,891435,892200,1,765,malR,58.30065359477125,
1873,gene,892214,893798,1,1584,malP,52.20959595959596,
1874,CDS,892214,893798,1,1584,malP,52.20959595959596,
1875,gene,893903,895625,1,1722,yfiB,53.019744483159116,
1876,CDS,893903,895625,1,1722,yfiB,53.019744483159116,
1877,gene,895618,897433,1,1815,yfiC,53.278236914600555,
1878,CDS,895618,897433,1,1815,yfiC,53.278236914600555,
1879,gene,897587,897992,1,405,catD,57.03703703703704,
1880,CDS,897587,897992,1,405,catD,57.03703703703704,
1881,gene,898009,898867,1,858,catE,49.76689976689977,
1882,CDS,898009,898867,1,858,catE,49.76689976689977,
1883,gene,898960,899905,1,945,yfiF,56.719576719576715,
1884,CDS,898960,899905,1,945,yfiF,56.719576719576715,
1885,gene,900079,901528,1,1449,yfiG,51.690821256038646,
1886,CDS,900079,901528,1,1449,yfiG,51.690821256038646,
1887,gene,901554,902496,1,942,yfiH,52.9723991507431,
1888,CDS,901554,902496,1,942,yfiH,52.9723991507431,
1889,gene,902505,903687,1,1182,yfiI,51.09983079526227,
1890,CDS,902505,903687,1,1182,yfiI,51.09983079526227,
1891,gene,903810,905013,1,1203,linJ,52.618453865336654,
1892,CDS,903810,905013,1,1203,linJ,52.618453865336654,
1893,gene,905009,905672,1,663,linK,51.88536953242836,
1894,CDS,905009,905672,1,663,linK,51.88536953242836,
1895,gene,905815,906751,1,936,bifL,51.81623931623932,
1896,CDS,905815,906751,1,936,bifL,51.81623931623932,
1897,gene,906763,907954,1,1191,bifM,54.91183879093199,
1898,CDS,906763,907954,1,1191,bifM,54.91183879093199,
1899,gene,907967,909125,1,1158,bifN,51.98618307426598,
1900,CDS,907967,909125,1,1158,bifN,51.98618307426598,
1901,gene,909197,909746,-1,549,padR,53.916211293260474,
1902,CDS,909197,909746,-1,549,padR,53.916211293260474,
1903,gene,910018,910651,1,633,estB,58.92575039494471,
1904,CDS,910018,910651,1,633,estB,58.92575039494471,
1905,gene,910839,911928,1,1089,icaC,55.46372819100092,
1906,CDS,910839,911928,1,1089,icaC,55.46372819100092,
1907,gene,911963,912581,-1,618,yfiR,55.8252427184466,
1908,CDS,911963,912581,-1,618,yfiR,55.8252427184466,
1909,gene,912546,913800,-1,1254,yfiS,52.791068580542266,
1910,CDS,912546,913800,-1,1254,yfiS,52.791068580542266,
1911,gene,913923,914460,1,537,bstA,50.83798882681564,
1912,CDS,913923,914460,1,537,bstA,50.83798882681564,
1913,gene,914456,916013,-1,1557,yfiU,50.93127809890816,
1914,CDS,914456,916013,-1,1557,yfiU,50.93127809890816,
1915,gene,916123,916606,-1,483,yfiV,55.90062111801242,
1916,CDS,916123,916606,-1,483,yfiV,55.90062111801242,
1917,gene,916777,919348,1,2571,mprF,53.90898483080513,
1918,CDS,916777,919348,1,2571,mprF,53.90898483080513,
1919,gene,919365,920343,-1,978,sxzY,57.97546012269939,
1920,CDS,919365,920343,-1,978,sxzY,57.97546012269939,
1921,gene,920473,921475,1,1002,sxzZ,48.70259481037924,
1922,CDS,920473,921475,1,1002,sxzZ,48.70259481037924,
1923,gene,921471,922503,1,1032,sxzA,51.356589147286826,
1924,CDS,921471,922503,1,1032,sxzA,51.356589147286826,
1925,gene,922617,923499,1,882,yfhB,52.83446712018141,
1926,CDS,922617,923499,1,882,yfhB,52.83446712018141,
1927,gene,923586,924171,1,585,yfhC,55.21367521367522,
1928,CDS,923586,924171,1,585,yfhC,55.21367521367522,
1929,gene,924209,924401,-1,192,yfhD,55.208333333333336,
1930,CDS,924209,924401,-1,192,yfhD,55.208333333333336,
1931,gene,924467,924578,-1,111,yfhE,57.65765765765766,
1932,CDS,924467,924578,-1,111,yfhE,57.65765765765766,
1933,gene,924632,925544,-1,912,yfhF,50.54824561403509,
1934,CDS,924632,925544,-1,912,yfhF,50.54824561403509,
1935,gene,925632,926427,1,795,recX,56.72955974842767,
1936,CDS,925632,926427,1,795,recX,56.72955974842767,
1937,gene,926428,926743,1,315,yfhH,56.82539682539682,
1938,CDS,926428,926743,1,315,yfhH,56.82539682539682,
1939,gene,926885,928079,1,1194,yfhI,52.01005025125628,
1940,CDS,926885,928079,1,1194,yfhI,52.01005025125628,
1941,gene,928111,928264,-1,153,sspK,57.51633986928104,
1942,CDS,928111,928264,-1,153,sspK,57.51633986928104,
1943,gene,928388,928658,1,270,yfhJ,58.88888888888889,
1944,CDS,928388,928658,1,270,yfhJ,58.88888888888889,
1945,gene,928802,929321,1,519,yfhK,55.8766859344894,
1946,CDS,928802,929321,1,519,yfhK,55.8766859344894,
1947,gene,929405,929738,1,333,spdL,54.65465465465466,
1948,CDS,929405,929738,1,333,spdL,54.65465465465466,
1949,gene,929724,930585,1,861,ephM,52.03252032520326,
1950,CDS,929724,930585,1,861,ephM,52.03252032520326,
1951,gene,930817,931807,1,990,csbB,59.3939393939394,
1952,CDS,930817,931807,1,990,csbB,59.3939393939394,
1953,gene,931878,934464,1,2586,yfhO,56.68986852281515,
1954,CDS,931878,934464,1,2586,yfhO,56.68986852281515,
1955,gene,934456,935440,-1,984,yfhP,54.67479674796748,
1956,CDS,934456,935440,-1,984,yfhP,54.67479674796748,
1957,gene,935655,936765,1,1110,mutY,54.234234234234236,
1958,CDS,935655,936765,1,1110,mutY,54.234234234234236,
1959,gene,936772,936997,-1,225,yfhS,56.00000000000001,
1960,CDS,936772,936997,-1,225,yfhS,56.00000000000001,
1961,gene,937078,937831,1,753,fabL,53.65205843293492,
1962,CDS,937078,937831,1,753,fabL,53.65205843293492,
1963,gene,937899,938154,1,255,sspE,58.82352941176471,
1964,CDS,937899,938154,1,255,sspE,58.82352941176471,
1965,gene,938242,938587,1,345,ygaB,55.362318840579704,
1966,CDS,938242,938587,1,345,ygaB,55.362318840579704,
1967,gene,938730,939261,1,531,ygaC,58.568738229755176,
1968,CDS,938730,939261,1,531,ygaC,58.568738229755176,
1969,gene,939348,941091,1,1743,ygaD,56.39701663798049,
1970,CDS,939348,941091,1,1743,ygaD,56.39701663798049,
1971,gene,941167,942229,-1,1062,ygaE,59.133709981167605,
1972,CDS,941167,942229,-1,1062,ygaE,59.133709981167605,
1973,gene,942448,943738,-1,1290,gsaB,52.63565891472868,
1974,CDS,942448,943738,-1,1290,gsaB,52.63565891472868,
1975,gene,943890,944364,1,474,bcp,58.438818565400844,
1976,CDS,943890,944364,1,474,bcp,58.438818565400844,
1977,gene,944486,944924,1,438,perR,54.337899543378995,
1978,CDS,944486,944924,1,438,perR,54.337899543378995,
1979,gene,944958,945312,-1,354,ygzB,62.71186440677966,
1980,CDS,944958,945312,-1,354,ygzB,62.71186440677966,
1981,gene,945519,946404,1,885,ygxA,60.451977401129945,
1982,CDS,945519,946404,1,885,ygxA,60.451977401129945,
1983,gene,946695,948250,1,1555,rrnD-16S,45.08038585209003,
1984,rRNA,946695,948250,1,1555,rrnD-16S,45.08038585209003,
1985,gene,948417,951345,1,2928,rrnD-23S,46.10655737704918,
1986,rRNA,948417,951345,1,2928,rrnD-23S,46.10655737704918,
1987,gene,951456,951572,1,116,rrnD-5S,41.37931034482759,
1988,rRNA,951456,951572,1,116,rrnD-5S,41.37931034482759,
1989,gene,951581,951656,1,75,asnTA,44.0,
1990,tRNA,951581,951656,1,75,asnTA,44.0,
1991,gene,951661,951753,1,92,trnD-Ser,42.391304347826086,
1992,tRNA,951661,951753,1,92,trnD-Ser,42.391304347826086,
1993,gene,951787,951859,1,72,trnD-Glu,38.88888888888889,
1994,tRNA,951787,951859,1,72,trnD-Glu,38.88888888888889,
1995,gene,951868,951944,1,76,trnD-Val,39.473684210526315,
1996,tRNA,951868,951944,1,76,trnD-Val,39.473684210526315,
1997,gene,951953,952030,1,77,trnD-Met,36.36363636363637,
1998,tRNA,951953,952030,1,77,trnD-Met,36.36363636363637,
1999,gene,952041,952118,1,77,trnD-Asp,36.36363636363637,
2000,tRNA,952041,952118,1,77,trnD-Asp,36.36363636363637,
2001,gene,952130,952206,1,76,trnD-Phe,40.78947368421053,
2002,tRNA,952130,952206,1,76,trnD-Phe,40.78947368421053,
2003,gene,952211,952284,1,73,trnD-Thr,47.94520547945205,
2004,tRNA,952211,952284,1,73,trnD-Thr,47.94520547945205,
2005,gene,952306,952391,1,85,trnD-Tyr,37.64705882352941,
2006,tRNA,952306,952391,1,85,trnD-Tyr,37.64705882352941,
2007,gene,952396,952470,1,74,trnD-Trp,45.94594594594595,
2008,tRNA,952396,952470,1,74,trnD-Trp,45.94594594594595,
2009,gene,952494,952570,1,76,trnD-His,42.10526315789473,
2010,tRNA,952494,952570,1,76,trnD-His,42.10526315789473,
2011,gene,952579,952651,1,72,trnD-Gln,44.44444444444444,
2012,tRNA,952579,952651,1,72,trnD-Gln,44.44444444444444,
2013,gene,952700,952775,1,75,glyTB,40.0,
2014,tRNA,952700,952775,1,75,glyTB,40.0,
2015,gene,952780,952851,1,71,cysTA,42.25352112676056,
2016,tRNA,952780,952851,1,71,cysTA,42.25352112676056,
2017,gene,952858,952947,1,89,leuTA,39.325842696629216,
2018,tRNA,952858,952947,1,89,leuTA,39.325842696629216,
2019,gene,953212,953294,1,82,leuTB,39.02439024390244,
2020,tRNA,953212,953294,1,82,leuTB,39.02439024390244,
2021,gene,953372,954149,-1,777,spo0M,54.69755469755469,
2022,CDS,953372,954149,-1,777,spo0M,54.69755469755469,
2023,gene,954290,954494,1,204,ygzA,61.274509803921575,
2024,CDS,954290,954494,1,204,ygzA,61.274509803921575,
2025,gene,954578,954851,-1,273,ygzC,62.27106227106227,
2026,CDS,954578,954851,-1,273,ygzC,62.27106227106227,
2027,gene,954892,955585,1,693,ygaJ,54.112554112554115,
2028,CDS,954892,955585,1,693,ygaJ,54.112554112554115,
2029,gene,955654,955762,1,108,tswD,49.074074074074076,
2030,misc_RNA,955654,955762,1,108,tswD,49.074074074074076,
2031,gene,955894,957667,1,1773,thiC,53.80710659898477,
2032,CDS,955894,957667,1,1773,thiC,53.80710659898477,
2033,gene,957704,959060,-1,1356,ygaK,53.83480825958702,
2034,CDS,957704,959060,-1,1356,ygaK,53.83480825958702,
2035,gene,959310,959508,1,198,senS,62.121212121212125,
2036,CDS,959310,959508,1,198,senS,62.121212121212125,
2037,gene,959534,960986,-1,1452,katA,54.40771349862259,
2038,CDS,959534,960986,-1,1452,katA,54.40771349862259,
2039,gene,961393,962161,1,768,ssuB,52.604166666666664,
2040,CDS,961393,962161,1,768,ssuB,52.604166666666664,
2041,gene,962178,963177,1,999,ssuA,57.35735735735735,
2042,CDS,962178,963177,1,999,ssuA,57.35735735735735,
2043,gene,963173,964004,1,831,ssuC,49.57882069795427,
2044,CDS,963173,964004,1,831,ssuC,49.57882069795427,
2045,gene,964026,965157,1,1131,ssuD,49.248452696728556,
2046,CDS,964026,965157,1,1131,ssuD,49.248452696728556,
2047,gene,965260,965797,1,537,ygaN,57.91433891992551,
2048,CDS,965260,965797,1,537,ygaN,57.91433891992551,
2049,gene,965908,966178,1,270,rpsNB,52.22222222222223,
2050,CDS,965908,966178,1,270,rpsNB,52.22222222222223,
2051,gene,966195,966669,-1,474,ygaO,55.69620253164557,
2052,CDS,966195,966669,-1,474,ygaO,55.69620253164557,
2053,gene,966670,966871,-1,201,ygzD,55.72139303482587,
2054,CDS,966670,966871,-1,201,ygzD,55.72139303482587,
2055,gene,967064,967138,1,74,trnSL-Gly1,48.64864864864865,
2056,tRNA,967064,967138,1,74,trnSL-Gly1,48.64864864864865,
2057,gene,967228,967852,-1,624,yhzB,57.21153846153846,
2058,CDS,967228,967852,-1,624,yhzB,57.21153846153846,
2059,gene,967934,969095,1,1161,queG,52.368647717484926,
2060,CDS,967934,969095,1,1161,queG,52.368647717484926,
2061,gene,969161,970097,1,936,yhbB,53.84615384615385,
2062,CDS,969161,970097,1,936,yhbB,53.84615384615385,
2063,gene,970134,970617,1,483,trmL,59.006211180124225,
2064,CDS,970134,970617,1,483,trmL,59.006211180124225,
2065,gene,970666,971383,1,717,yhbD,59.13528591352859,
2066,CDS,970666,971383,1,717,yhbD,59.13528591352859,
2067,gene,971373,972087,1,714,yhbE,53.36134453781513,
2068,CDS,971373,972087,1,714,yhbE,53.36134453781513,
2069,gene,972098,972806,1,708,yhbF,53.954802259887,
2070,CDS,972098,972806,1,708,yhbF,53.954802259887,
2071,gene,973155,975051,1,1896,prkA,56.0126582278481,
2072,CDS,973155,975051,1,1896,prkA,56.0126582278481,
2073,gene,975230,976409,1,1179,yhbH,58.35453774385072,
2074,CDS,975230,976409,1,1179,yhbH,58.35453774385072,
2075,gene,976568,977033,1,465,yhbI,56.55913978494623,
2076,CDS,976568,977033,1,465,yhbI,56.55913978494623,
2077,gene,977068,977734,1,666,yhbJ,62.312312312312315,
2078,CDS,977068,977734,1,666,yhbJ,62.312312312312315,
2079,gene,977774,979373,1,1599,yhcA,56.16010006253909,
2080,CDS,977774,979373,1,1599,yhcA,56.16010006253909,
2081,gene,979395,979926,1,531,yhcB,51.60075329566855,
2082,CDS,979395,979926,1,531,yhcB,51.60075329566855,
2083,gene,979938,980313,1,375,yhcC,54.666666666666664,
2084,CDS,979938,980313,1,375,yhcC,54.666666666666664,
2085,gene,980312,980468,1,156,yhcD,64.1025641025641,
2086,CDS,980312,980468,1,156,yhcD,64.1025641025641,
2087,gene,980472,981234,1,762,yhcE,61.28608923884514,
2088,CDS,980472,981234,1,762,yhcE,61.28608923884514,
2089,gene,981236,981602,1,366,yhcF,56.557377049180324,
2090,CDS,981236,981602,1,366,yhcF,56.557377049180324,
2091,gene,981603,982302,1,699,yhcG,57.5107296137339,
2092,CDS,981603,982302,1,699,yhcG,57.5107296137339,
2093,gene,982318,983236,1,918,yhcH,57.18954248366013,
2094,CDS,982318,983236,1,918,yhcH,57.18954248366013,
2095,gene,983228,984170,1,942,yhcI,58.28025477707006,
2096,CDS,983228,984170,1,942,yhcI,58.28025477707006,
2097,gene,984261,984465,-1,204,cspB,60.29411764705882,
2098,CDS,984261,984465,-1,204,cspB,60.29411764705882,
2099,gene,984900,985731,1,831,yhcJ,56.07701564380265,
2100,CDS,984900,985731,1,831,yhcJ,56.07701564380265,
2101,gene,985733,986813,-1,1080,dgcK,59.351851851851855,
2102,CDS,985733,986813,-1,1080,dgcK,59.351851851851855,
2103,gene,986985,988377,1,1392,tcyP,54.0948275862069,
2104,CDS,986985,988377,1,1392,tcyP,54.0948275862069,
2105,gene,988416,988872,-1,456,yhcM,53.07017543859649,
2106,CDS,988416,988872,-1,456,yhcM,53.07017543859649,
2107,gene,989021,989591,1,570,yhcN,61.40350877192983,
2108,CDS,989021,989591,1,570,yhcN,61.40350877192983,
2109,gene,989711,990680,1,969,yhcO,58.10113519091848,
2110,CDS,989711,990680,1,969,yhcO,58.10113519091848,
2111,gene,990611,991265,-1,654,yhcQ,56.727828746177366,
2112,CDS,990611,991265,-1,654,yhcQ,56.727828746177366,
2113,gene,991347,995001,1,3654,mncR,54.57033388067871,
2114,CDS,991347,995001,1,3654,mncR,54.57033388067871,
2115,gene,994997,995594,1,597,srtA,55.27638190954774,
2116,CDS,994997,995594,1,597,srtA,55.27638190954774,
2117,gene,995623,996532,-1,909,yhcT,51.7051705170517,
2118,CDS,995623,996532,-1,909,yhcT,51.7051705170517,
2119,gene,996642,997038,1,396,yhcU,61.86868686868687,
2120,CDS,996642,997038,1,396,yhcU,61.86868686868687,
2121,gene,997174,997597,1,423,yhcV,51.77304964539007,
2122,CDS,997174,997597,1,423,yhcV,51.77304964539007,
2123,gene,997723,998386,1,663,glpW,54.44947209653092,
2124,CDS,997723,998386,1,663,glpW,54.44947209653092,
2125,gene,998401,999943,1,1542,yhcX,55.447470817120625,
2126,CDS,998401,999943,1,1542,yhcX,55.447470817120625,
2127,gene,1000026,1000218,1,192,yhzG,57.8125,
2128,misc_feature,1000026,1000218,1,192,yhzG,57.8125,
2129,gene,1000363,1001716,1,1353,yhxA,49.150036954915,
2130,CDS,1000363,1001716,1,1353,yhxA,49.150036954915,
2131,gene,1001743,1002322,1,579,glpP,56.303972366148535,
2132,CDS,1001743,1002322,1,579,glpP,56.303972366148535,
2133,gene,1002500,1003325,1,825,glpF,53.696969696969695,
2134,CDS,1002500,1003325,1,825,glpF,53.696969696969695,
2135,gene,1003343,1004834,1,1491,glpK,53.58819584171697,
2136,CDS,1003343,1004834,1,1491,glpK,53.58819584171697,
2137,gene,1004974,1006642,1,1668,glpD,54.55635491606715,
2138,CDS,1004974,1006642,1,1668,glpD,54.55635491606715,
2139,gene,1006773,1008519,1,1746,pgcA,54.009163802978236,
2140,CDS,1006773,1008519,1,1746,pgcA,54.009163802978236,
2141,gene,1008667,1009807,1,1140,yhcY,54.03508771929825,
2142,CDS,1008667,1009807,1,1140,yhcY,54.03508771929825,
2143,gene,1009803,1010448,1,645,yhcZ,56.27906976744186,
2144,CDS,1009803,1010448,1,645,yhcZ,56.27906976744186,
2145,gene,1010444,1010969,1,525,azr,55.61904761904762,
2146,CDS,1010444,1010969,1,525,azr,55.61904761904762,
2147,gene,1010983,1011226,-1,243,yhdB,62.96296296296296,
2148,CDS,1010983,1011226,-1,243,yhdB,62.96296296296296,
2149,gene,1011426,1011750,1,324,yhdC,56.481481481481474,
2150,CDS,1011426,1011750,1,324,yhdC,56.481481481481474,
2151,gene,1011791,1013258,-1,1467,lytF,57.12338104976141,
2152,CDS,1011791,1013258,-1,1467,lytF,57.12338104976141,
2153,gene,1013410,1013851,-1,441,nsrR,58.730158730158735,
2154,CDS,1013410,1013851,-1,441,nsrR,58.730158730158735,
2155,gene,1013957,1015616,-1,1659,ygxB,55.213984327908385,
2156,CDS,1013957,1015616,-1,1659,ygxB,55.213984327908385,
2157,gene,1015646,1017053,1,1407,spoVR,56.28997867803838,
2158,CDS,1015646,1017053,1,1407,spoVR,56.28997867803838,
2159,gene,1017082,1018468,-1,1386,phoA,55.05050505050505,
2160,CDS,1017082,1018468,-1,1386,phoA,55.05050505050505,
2161,gene,1018997,1020002,1,1005,lytE,58.507462686567166,
2162,CDS,1018997,1020002,1,1005,lytE,58.507462686567166,cell wall dl-endopeptidase; phosphatase-associated protein (major autolysin)
2163,gene,1020072,1020948,-1,876,citR,56.278538812785385,
2164,CDS,1020072,1020948,-1,876,citR,56.278538812785385,
2165,gene,1021056,1022157,1,1101,citA,53.86012715712988,
2166,CDS,1021056,1022157,1,1101,citA,53.86012715712988,
2167,gene,1022230,1023100,1,870,yhdF,50.919540229885065,
2168,CDS,1022230,1023100,1,870,yhdF,50.919540229885065,
2169,gene,1023349,1024747,1,1398,bcaP,52.71816881258942,
2170,CDS,1023349,1024747,1,1398,bcaP,52.71816881258942,
2171,gene,1024864,1026220,1,1356,yhdH,54.9410029498525,
2172,CDS,1024864,1026220,1,1356,yhdH,54.9410029498525,
2173,gene,1026254,1027664,-1,1410,yhdI,52.76595744680851,
2174,CDS,1026254,1027664,-1,1410,yhdI,52.76595744680851,
2175,gene,1027773,1028202,1,429,yhdJ,57.57575757575758,
2176,CDS,1027773,1028202,1,429,yhdJ,57.57575757575758,
2177,gene,1028232,1028523,-1,291,asiMB,54.98281786941581,
2178,CDS,1028232,1028523,-1,291,asiMB,54.98281786941581,
2179,gene,1028510,1029587,-1,1077,asiMA,57.567316620241414,
2180,CDS,1028510,1029587,-1,1077,asiMA,57.567316620241414,
2181,gene,1029576,1030068,-1,492,sigM,60.36585365853659,
2182,CDS,1029576,1030068,-1,492,sigM,60.36585365853659,
2183,gene,1030264,1031260,1,996,akrN,53.41365461847389,
2184,CDS,1030264,1031260,1,996,akrN,53.41365461847389,
2185,gene,1031394,1031994,1,600,plsC,55.833333333333336,
2186,CDS,1031394,1031994,1,600,plsC,55.833333333333336,
2187,gene,1032062,1033397,-1,1335,yhdP,57.078651685393254,
2188,CDS,1032062,1033397,-1,1335,yhdP,57.078651685393254,
2189,gene,1033457,1033889,-1,432,cueR,55.55555555555556,
2190,CDS,1033457,1033889,-1,432,cueR,55.55555555555556,
2191,gene,1034045,1035227,1,1182,yhdR,54.73773265651438,
2192,CDS,1034045,1035227,1,1182,yhdR,54.73773265651438,
2193,gene,1035553,1036939,1,1386,yhdT,53.246753246753244,
2194,CDS,1035553,1036939,1,1386,yhdT,53.246753246753244,
2195,gene,1036952,1037309,-1,357,crcBA,52.38095238095239,
2196,CDS,1036952,1037309,-1,357,crcBA,52.38095238095239,
2197,gene,1037305,1037701,-1,396,crcBB,51.26262626262626,
2198,CDS,1037305,1037701,-1,396,crcBB,51.26262626262626,
2199,gene,1037687,1038419,-1,732,yhdW,55.19125683060109,
2200,CDS,1037687,1038419,-1,732,yhdW,55.19125683060109,
2201,gene,1038652,1038760,1,108,yhdX,59.25925925925925,
2202,CDS,1038652,1038760,1,108,yhdX,59.25925925925925,
2203,gene,1038908,1040024,1,1116,mscY,56.63082437275986,
2204,CDS,1038908,1040024,1,1116,mscY,56.63082437275986,
2205,gene,1040093,1040837,1,744,srtN,51.88172043010753,
2206,CDS,1040093,1040837,1,744,srtN,51.88172043010753,
2207,gene,1040860,1041709,-1,849,yheN,54.53474676089517,
2208,CDS,1040860,1041709,-1,849,yheN,54.53474676089517,
2209,gene,1041993,1042842,1,849,dat,52.65017667844523,
2210,CDS,1041993,1042842,1,849,dat,52.65017667844523,
2211,gene,1042884,1044246,-1,1362,nhaC,54.77239353891336,
2212,CDS,1042884,1044246,-1,1362,nhaC,54.77239353891336,
2213,gene,1044372,1044873,-1,501,nhaX,53.89221556886228,
2214,CDS,1044372,1044873,-1,501,nhaX,53.89221556886228,
2215,gene,1045036,1045198,1,162,bmrB,58.0246913580247,
2216,CDS,1045036,1045198,1,162,bmrB,58.0246913580247,
2217,gene,1045317,1047075,1,1758,bmrC,53.92491467576792,
2218,CDS,1045317,1047075,1,1758,bmrC,53.92491467576792,
2219,gene,1047071,1049093,1,2022,bmrD,55.24233432245301,
2220,CDS,1047071,1049093,1,2022,bmrD,55.24233432245301,
2221,gene,1049141,1049762,-1,621,yheG,52.65700483091788,
2222,CDS,1049141,1049762,-1,621,yheG,52.65700483091788,
2223,gene,1049800,1049926,-1,126,yheF,60.317460317460316,
2224,CDS,1049800,1049926,-1,126,yheF,60.317460317460316,
2225,gene,1050030,1050234,-1,204,sspB,54.41176470588235,
2226,CDS,1050030,1050234,-1,204,sspB,54.41176470588235,
2227,gene,1050442,1050661,-1,219,yheE,57.534246575342465,
2228,CDS,1050442,1050661,-1,219,yheE,57.534246575342465,
2229,gene,1050810,1052172,-1,1362,spaD,55.21292217327459,
2230,CDS,1050810,1052172,-1,1362,spaD,55.21292217327459,
2231,gene,1052161,1053253,-1,1092,spaC,56.227106227106226,
2232,CDS,1052161,1053253,-1,1092,spaC,56.227106227106226,
2233,gene,1053519,1054653,1,1134,yheB,55.20282186948854,
2234,CDS,1053519,1054653,1,1134,yheB,55.20282186948854,
2235,gene,1054745,1055099,1,354,yheA,57.34463276836158,
2236,CDS,1054745,1055099,1,354,yheA,57.34463276836158,
2237,gene,1055142,1056216,-1,1074,yhaZ,60.42830540037244,
2238,CDS,1055142,1056216,-1,1074,yhaZ,60.42830540037244,
2239,gene,1056701,1057568,1,867,yhaX,54.325259515570934,
2240,CDS,1056701,1057568,1,867,yhaX,54.325259515570934,
2241,gene,1057679,1059185,1,1506,hemZ,55.046480743691895,
2242,CDS,1057679,1059185,1,1506,hemZ,55.046480743691895,
2243,gene,1059202,1060420,-1,1218,khtU,53.44827586206896,
2244,CDS,1059202,1060420,-1,1218,khtU,53.44827586206896,
2245,gene,1060426,1060924,-1,498,khtT,56.62650602409639,
2246,CDS,1060426,1060924,-1,498,khtT,56.62650602409639,
2247,gene,1060987,1061326,-1,339,khtS,51.03244837758112,
2248,CDS,1060987,1061326,-1,339,khtS,51.03244837758112,
2249,gene,1061490,1062258,1,768,yhaR,50.520833333333336,
2250,CDS,1061490,1062258,1,768,yhaR,50.520833333333336,
2251,gene,1062278,1062464,-1,186,yhzD,56.98924731182796,
2252,CDS,1062278,1062464,-1,186,yhzD,56.98924731182796,
2253,gene,1062590,1063487,1,897,yhaQ,55.406911928651056,
2254,CDS,1062590,1063487,1,897,yhaQ,55.406911928651056,
2255,gene,1063479,1064739,1,1260,yhaP,54.047619047619044,
2256,CDS,1063479,1064739,1,1260,yhaP,54.047619047619044,
2257,gene,1064845,1066072,1,1227,yhaO,52.24123879380603,
2258,CDS,1064845,1066072,1,1227,yhaO,52.24123879380603,
2259,gene,1066076,1068968,1,2892,sbcE,53.42323651452282,
2260,CDS,1066076,1068968,1,2892,sbcE,53.42323651452282,
2261,gene,1069041,1069986,1,945,yhaM,55.66137566137566,
2262,CDS,1069041,1069986,1,945,yhaM,55.66137566137566,
2263,gene,1070110,1070323,1,213,yhaL,58.68544600938967,
2264,CDS,1070110,1070323,1,213,yhaL,58.68544600938967,
2265,gene,1070363,1071242,-1,879,prsA,60.068259385665534,
2266,CDS,1070363,1071242,-1,879,prsA,60.068259385665534,
2267,gene,1071401,1071488,1,87,sscA,56.32183908045977,
2268,CDS,1071401,1071488,1,87,sscA,56.32183908045977,
2269,gene,1071612,1071699,1,87,sscB,62.06896551724138,
2270,CDS,1071612,1071699,1,87,sscB,62.06896551724138,
2271,gene,1072041,1072560,-1,519,yhaJ,59.34489402697495,
2272,CDS,1072041,1072560,-1,519,yhaJ,59.34489402697495,
2273,gene,1072767,1073109,1,342,yhaI,59.06432748538012,
2274,CDS,1072767,1073109,1,342,yhaI,59.06432748538012,
2275,gene,1073105,1073717,-1,612,scoC,58.16993464052288,
2276,CDS,1073105,1073717,-1,612,scoC,58.16993464052288,
2277,gene,1073894,1074251,-1,357,yhaH,56.30252100840336,
2278,CDS,1073894,1074251,-1,357,yhaH,56.30252100840336,
2279,gene,1074380,1074572,1,192,yhzF,55.208333333333336,
2280,CDS,1074380,1074572,1,192,yhzF,55.208333333333336,
2281,gene,1074645,1075164,-1,519,trpP,52.601156069364166,
2282,CDS,1074645,1075164,-1,519,trpP,52.601156069364166,
2283,gene,1075288,1076368,-1,1080,serC,54.53703703703704,
2284,CDS,1075288,1076368,-1,1080,serC,54.53703703703704,
2285,gene,1076514,1076952,-1,438,hinT,58.21917808219178,
2286,CDS,1076514,1076952,-1,438,hinT,58.21917808219178,
2287,gene,1077439,1078183,1,744,ecsA,53.62903225806451,
2288,CDS,1077439,1078183,1,744,ecsA,53.62903225806451,
2289,gene,1078175,1079402,1,1227,ecsB,53.708231458842704,
2290,CDS,1078175,1079402,1,1227,ecsB,53.708231458842704,
2291,gene,1079421,1080132,1,711,ecsC,55.9774964838256,
2292,CDS,1079421,1080132,1,711,ecsC,55.9774964838256,
2293,gene,1080149,1081340,-1,1191,sndC,49.87405541561713,
2294,CDS,1080149,1081340,-1,1191,sndC,49.87405541561713,
2295,gene,1081412,1082804,-1,1392,yhfA,50.7183908045977,
2296,CDS,1081412,1082804,-1,1392,yhfA,50.7183908045977,
2297,gene,1082869,1083184,-1,315,yhgB,56.19047619047619,
2298,CDS,1082869,1083184,-1,315,yhgB,56.19047619047619,
2299,gene,1083228,1083729,-1,501,hmoB,54.690618762475054,
2300,CDS,1083228,1083729,-1,501,hmoB,54.690618762475054,
2301,gene,1083850,1085995,1,2145,pbpF,54.312354312354316,
2302,CDS,1083850,1085995,1,2145,pbpF,54.312354312354316,
2303,gene,1086116,1087178,1,1062,hemE,52.16572504708098,
2304,CDS,1086116,1087178,1,1062,hemE,52.16572504708098,
2305,gene,1087249,1088182,1,933,hemH,54.555198285101824,
2306,CDS,1087249,1088182,1,933,hemH,54.555198285101824,
2307,gene,1088196,1089609,1,1413,hemY,51.52158527954707,
2308,CDS,1088196,1089609,1,1413,hemY,51.52158527954707,
2309,gene,1089754,1090330,1,576,yhgD,56.076388888888886,
2310,CDS,1089754,1090330,1,576,yhgD,56.076388888888886,
2311,gene,1090400,1092728,1,2328,yhgE,55.4553264604811,
2312,CDS,1090400,1092728,1,2328,yhgE,55.4553264604811,
2313,gene,1092769,1093747,-1,978,fabHB,52.04498977505112,
2314,CDS,1092769,1093747,-1,978,fabHB,52.04498977505112,
2315,gene,1093873,1094650,1,777,yhfC,54.56885456885456,
2316,CDS,1093873,1094650,1,777,yhfC,54.56885456885456,
2317,gene,1095062,1096103,1,1041,yhfE,53.41018251681076,
2318,CDS,1095062,1096103,1,1041,yhfE,53.41018251681076,
2319,gene,1096115,1096523,1,408,yhfF,56.61764705882353,
2320,CDS,1096115,1096523,1,408,yhfF,56.61764705882353,
2321,gene,1096559,1097849,-1,1290,gltT,55.89147286821705,
2322,CDS,1096559,1097849,-1,1290,gltT,55.89147286821705,
2323,gene,1098119,1098260,-1,141,yhfH,63.829787234042556,
2324,CDS,1098119,1098260,-1,141,yhfH,63.829787234042556,
2325,gene,1098411,1099146,1,735,yhfI,53.197278911564624,
2326,CDS,1098411,1099146,1,735,yhfI,53.197278911564624,
2327,gene,1099158,1100154,1,996,lplJ,57.831325301204814,
2328,CDS,1099158,1100154,1,996,lplJ,57.831325301204814,
2329,gene,1100218,1100863,1,645,yhfK,50.85271317829457,
2330,CDS,1100218,1100863,1,645,yhfK,50.85271317829457,
2331,gene,1100979,1102521,1,1542,lcfB,50.583657587548636,
2332,CDS,1100979,1102521,1,1542,lcfB,50.583657587548636,
2333,gene,1102559,1102955,-1,396,yhfM,60.1010101010101,
2334,CDS,1102559,1102955,-1,396,yhfM,60.1010101010101,
2335,gene,1103103,1104384,1,1281,yhfN,55.0351288056206,
2336,CDS,1103103,1104384,1,1281,yhfN,55.0351288056206,
2337,gene,1104422,1105568,-1,1146,aprE,53.57766143106457,
2338,CDS,1104422,1105568,-1,1146,aprE,53.57766143106457,
2339,gene,1106002,1106452,1,450,yhfO,54.666666666666664,
2340,CDS,1106002,1106452,1,450,yhfO,54.666666666666664,
2341,gene,1106523,1107516,1,993,yhfP,49.64753272910373,
2342,CDS,1106523,1107516,1,993,yhfP,49.64753272910373,
2343,gene,1107732,1108704,1,972,yhfQ,54.73251028806584,
2344,CDS,1107732,1108704,1,972,yhfQ,54.73251028806584,
2345,gene,1108735,1109317,-1,582,phoE,52.749140893470795,
2346,CDS,1108735,1109317,-1,582,phoE,52.749140893470795,
2347,gene,1109387,1110482,-1,1095,yhfS,47.305936073059364,
2348,CDS,1109387,1110482,-1,1095,yhfS,47.305936073059364,
2349,gene,1110478,1111918,-1,1440,yhfT,50.90277777777777,
2350,CDS,1110478,1111918,-1,1440,yhfT,50.90277777777777,
2351,gene,1111924,1112485,-1,561,bioY,52.584670231729056,
2352,CDS,1111924,1112485,-1,561,bioY,52.584670231729056,
2353,gene,1112619,1113918,-1,1299,hemAT,58.8144726712856,
2354,CDS,1112619,1113918,-1,1299,hemAT,58.8144726712856,
2355,gene,1114056,1115586,-1,1530,yhfW,54.31372549019608,
2356,CDS,1114056,1115586,-1,1530,yhfW,54.31372549019608,
2357,gene,1115697,1116555,1,858,yhxC,51.981351981351985,
2358,CDS,1115697,1116555,1,858,yhxC,51.981351981351985,
2359,gene,1116582,1116816,-1,234,yhzC,58.97435897435898,
2360,CDS,1116582,1116816,-1,234,yhzC,58.97435897435898,
2361,gene,1117108,1117687,1,579,comK,55.95854922279793,
2362,CDS,1117108,1117687,1,579,comK,55.95854922279793,
2363,gene,1117733,1118633,-1,900,yhxD,51.22222222222222,
2364,CDS,1117733,1118633,-1,900,yhxD,51.22222222222222,
2365,gene,1118849,1119119,1,270,yhjA,54.074074074074076,
2366,CDS,1118849,1119119,1,270,yhjA,54.074074074074076,
2367,gene,1119161,1120631,-1,1470,yhjB,50.204081632653065,
2368,CDS,1119161,1120631,-1,1470,yhjB,50.204081632653065,
2369,gene,1120627,1120828,-1,201,yhjC,55.223880597014926,
2370,CDS,1120627,1120828,-1,201,yhjC,55.223880597014926,
2371,gene,1121035,1121398,-1,363,yhjD,59.77961432506888,
2372,CDS,1121035,1121398,-1,363,yhjD,59.77961432506888,
2373,gene,1121549,1122173,1,624,yhjE,52.72435897435898,
2374,CDS,1121549,1122173,1,624,yhjE,52.72435897435898,
2375,gene,1122174,1122681,1,507,sipV,58.57988165680473,
2376,CDS,1122174,1122681,1,507,sipV,58.57988165680473,
2377,gene,1122861,1124361,1,1500,yhjG,46.666666666666664,
2378,CDS,1122861,1124361,1,1500,yhjG,46.666666666666664,
2379,gene,1124437,1124965,1,528,yhjH,57.1969696969697,
2380,CDS,1124437,1124965,1,528,yhjH,57.1969696969697,
2381,gene,1125122,1126328,-1,1206,glcP,66.4179104477612,
2382,CDS,1125122,1126328,-1,1206,glcP,66.4179104477612,
2383,gene,1126399,1127452,-1,1053,ntdC,62.7730294396961,
2384,CDS,1126399,1127452,-1,1053,ntdC,62.7730294396961,
2385,gene,1127465,1128314,-1,849,ntdB,64.89988221436984,
2386,CDS,1127465,1128314,-1,849,ntdB,64.89988221436984,
2387,gene,1128285,1129611,-1,1326,ntdA,65.68627450980392,
2388,CDS,1128285,1129611,-1,1326,ntdA,65.68627450980392,
2389,gene,1129714,1130704,1,990,ntdR,64.44444444444444,
2390,CDS,1129714,1130704,1,990,ntdR,64.44444444444444,
2391,gene,1130917,1132072,-1,1155,yhjN,49.87012987012987,
2392,CDS,1130917,1132072,-1,1155,yhjN,49.87012987012987,
2393,gene,1132178,1133384,-1,1206,yhjO,51.741293532338304,
2394,CDS,1132178,1133384,-1,1206,yhjO,51.741293532338304,
2395,gene,1133497,1135225,1,1728,yhjP,52.48842592592593,
2396,CDS,1133497,1135225,1,1728,yhjP,52.48842592592593,
2397,gene,1135254,1135581,-1,327,yhjQ,50.45871559633027,
2398,CDS,1135254,1135581,-1,327,yhjQ,50.45871559633027,
2399,gene,1135698,1136136,-1,438,yhjR,52.28310502283106,
2400,CDS,1135698,1136136,-1,438,yhjR,52.28310502283106,
2401,gene,1136319,1139820,1,3501,addB,50.956869465866895,
2402,CDS,1136319,1139820,1,3501,addB,50.956869465866895,
2403,gene,1139806,1143505,1,3699,addA,51.23006217896729,
2404,CDS,1139806,1143505,1,3699,addA,51.23006217896729,
2405,gene,1143576,1144752,1,1176,sbcD,48.46938775510204,
2406,CDS,1143576,1144752,1,1176,sbcD,48.46938775510204,
2407,gene,1144748,1148141,1,3393,sbcC,51.930445033893314,
2408,CDS,1144748,1148141,1,3393,sbcC,51.930445033893314,
2409,gene,1148154,1148457,1,303,hlpB,54.78547854785478,
2410,CDS,1148154,1148457,1,303,hlpB,54.78547854785478,
2411,gene,1148493,1148712,-1,219,gerPF,55.70776255707762,
2412,CDS,1148493,1148712,-1,219,gerPF,55.70776255707762,
2413,gene,1148743,1149145,-1,402,gerPE,53.98009950248757,
2414,CDS,1148743,1149145,-1,402,gerPE,53.98009950248757,
2415,gene,1149144,1149321,-1,177,gerPD,53.10734463276836,
2416,CDS,1149144,1149321,-1,177,gerPD,53.10734463276836,
2417,gene,1149317,1149935,-1,618,gerPC,55.98705501618123,
2418,CDS,1149317,1149935,-1,618,gerPC,55.98705501618123,
2419,gene,1149957,1150191,-1,234,gerPB,50.85470085470085,
2420,CDS,1149957,1150191,-1,234,gerPB,50.85470085470085,
2421,gene,1150205,1150427,-1,222,gerPA,49.549549549549546,
2422,CDS,1150205,1150427,-1,222,gerPA,49.549549549549546,
2423,gene,1150849,1151020,-1,171,pchI,63.74269005847953,
2424,CDS,1150849,1151020,-1,171,pchI,63.74269005847953,
2425,gene,1151165,1152089,-1,924,yisJ,54.65367965367965,
2426,CDS,1151165,1152089,-1,924,yisJ,54.65367965367965,
2427,gene,1152243,1153149,1,906,mblK,53.53200883002207,
2428,CDS,1152243,1153149,1,906,mblK,53.53200883002207,
2429,gene,1153264,1153621,1,357,yisL,54.621848739495796,
2430,CDS,1153264,1153621,1,357,yisL,54.621848739495796,
2431,gene,1153788,1156473,1,2685,wprA,55.08379888268157,
2432,CDS,1153788,1156473,1,2685,wprA,55.08379888268157,cell wall-associated protease
2433,gene,1156503,1157091,-1,588,yisN,51.53061224489795,
2434,CDS,1156503,1157091,-1,588,yisN,51.53061224489795,
2435,gene,1157236,1159081,1,1845,asnO,52.46612466124662,
2436,CDS,1157236,1159081,1,1845,asnO,52.46612466124662,
2437,gene,1159210,1159690,-1,480,yizA,65.625,
2438,CDS,1159210,1159690,-1,480,yizA,65.625,
2439,gene,1159921,1160746,1,825,farP,53.21212121212121,
2440,CDS,1159921,1160746,1,825,farP,53.21212121212121,
2441,gene,1160775,1162143,-1,1368,yisQ,54.60526315789473,
2442,CDS,1160775,1162143,-1,1368,yisQ,54.60526315789473,
2443,gene,1162266,1163130,1,864,yisR,52.54629629629629,
2444,CDS,1162266,1163130,1,864,yisR,52.54629629629629,
2445,gene,1163147,1164161,1,1014,iolQ,52.366863905325445,
2446,CDS,1163147,1164161,1,1014,iolQ,52.366863905325445,
2447,gene,1164369,1165398,1,1029,iolX,51.60349854227405,
2448,CDS,1164369,1165398,1,1029,iolX,51.60349854227405,
2449,gene,1165448,1165958,-1,510,yisT,54.11764705882353,
2450,CDS,1165448,1165958,-1,510,yisT,54.11764705882353,
2451,gene,1166007,1166670,-1,663,yisU,52.1870286576169,
2452,CDS,1166007,1166670,-1,663,yisU,52.1870286576169,
2453,gene,1166736,1168191,1,1455,yisV,50.034364261168385,
2454,CDS,1166736,1168191,1,1455,yisV,50.034364261168385,
2455,gene,1168198,1168837,-1,639,yisX,55.08607198748044,
2456,CDS,1168198,1168837,-1,639,yisX,55.08607198748044,
2457,gene,1169042,1169849,1,807,yisY,52.540272614622054,
2458,CDS,1169042,1169849,1,807,yisY,52.540272614622054,
2459,gene,1169876,1170476,-1,600,yisZ,53.166666666666664,
2460,CDS,1169876,1170476,-1,600,yisZ,53.166666666666664,
2461,gene,1170472,1171642,-1,1170,yitA,49.914529914529915,
2462,CDS,1170472,1171642,-1,1170,yitA,49.914529914529915,
2463,gene,1171754,1172465,-1,711,yitB,51.75808720112518,
2464,CDS,1171754,1172465,-1,711,yitB,51.75808720112518,
2465,gene,1172649,1173336,1,687,slpH,53.12954876273653,
2466,CDS,1172649,1173336,1,687,slpH,53.12954876273653,
2467,gene,1173332,1174091,1,759,slpS,57.180500658761524,
2468,CDS,1173332,1174091,1,759,slpS,57.180500658761524,
2469,gene,1174135,1174765,-1,630,yitE,54.12698412698413,
2470,CDS,1174135,1174765,-1,630,yitE,54.12698412698413,
2471,gene,1174860,1175976,-1,1116,yitF,49.73118279569893,
2472,CDS,1174860,1175976,-1,1116,yitF,49.73118279569893,
2473,gene,1175984,1177253,-1,1269,yitG,54.37352245862884,
2474,CDS,1175984,1177253,-1,1269,yitG,54.37352245862884,
2475,gene,1177364,1178213,-1,849,yitH,53.592461719670204,
2476,CDS,1177364,1178213,-1,849,yitH,53.592461719670204,
2477,gene,1178217,1178667,-1,450,yitI,50.66666666666667,
2478,CDS,1178217,1178667,-1,450,yitI,50.66666666666667,
2479,gene,1178756,1180595,-1,1839,samT,51.71288743882545,
2480,CDS,1178756,1180595,-1,1839,samT,51.71288743882545,
2481,gene,1180684,1180802,-1,118,mswK,50.0,
2482,misc_RNA,1180684,1180802,-1,118,mswK,50.0,
2483,gene,1180908,1181400,-1,492,yitK,57.72357723577236,
2484,CDS,1180908,1181400,-1,492,yitK,57.72357723577236,
2485,gene,1181498,1182395,1,897,yitL,53.28874024526199,
2486,CDS,1181498,1182395,1,897,yitL,53.28874024526199,
2487,gene,1182447,1183032,-1,585,yitM,58.2905982905983,
2488,CDS,1182447,1183032,-1,585,yitM,58.2905982905983,
2489,gene,1183028,1183958,-1,930,yitO,53.97849462365591,
2490,CDS,1183028,1183958,-1,930,yitO,53.97849462365591,
2491,gene,1183942,1184479,-1,537,yitP,53.63128491620112,
2492,CDS,1183942,1184479,-1,537,yitP,53.63128491620112,
2493,gene,1184656,1185004,1,348,yizB,56.896551724137936,
2494,CDS,1184656,1185004,1,348,yizB,56.896551724137936,
2495,gene,1185000,1185588,1,588,yitQ,53.2312925170068,
2496,CDS,1185000,1185588,1,588,yitQ,53.2312925170068,
2497,gene,1185607,1185901,1,294,yitR,60.8843537414966,
2498,CDS,1185607,1185901,1,294,yitR,60.8843537414966,
2499,gene,1186036,1187653,1,1617,nprB,54.421768707483,
2500,CDS,1186036,1187653,1,1617,nprB,54.421768707483,
2501,gene,1187699,1188551,-1,852,fakBB,54.10798122065727,
2502,CDS,1187699,1188551,-1,852,fakBB,54.10798122065727,
2503,gene,1188688,1189531,1,843,yitT,55.51601423487544,
2504,CDS,1188688,1189531,1,843,yitT,55.51601423487544,
2505,gene,1189645,1190005,1,360,ipi,58.88888888888889,
2506,CDS,1189645,1190005,1,360,ipi,58.88888888888889,
2507,gene,1190035,1190233,-1,198,yizC,56.060606060606055,
2508,CDS,1190035,1190233,-1,198,yizC,56.060606060606055,
2509,gene,1190489,1191302,-1,813,ribZC,54.36654366543665,
2510,CDS,1190489,1191302,-1,813,ribZC,54.36654366543665,
2511,gene,1191422,1192190,1,768,yitV,51.171875,
2512,CDS,1191422,1192190,1,768,yitV,51.171875,
2513,gene,1192253,1192562,1,309,yitW,54.0453074433657,
2514,CDS,1192253,1192562,1,309,yitW,54.0453074433657,
2515,gene,1192857,1194288,1,1431,yitY,55.13626834381551,
2516,CDS,1192857,1194288,1,1431,yitY,55.13626834381551,
2517,gene,1194332,1194827,1,495,yitZ,55.757575757575765,
2518,CDS,1194332,1194827,1,495,yitZ,55.757575757575765,
2519,gene,1195033,1196071,1,1038,argC,53.75722543352601,
2520,CDS,1195033,1196071,1,1038,argC,53.75722543352601,
2521,gene,1196090,1197311,1,1221,argJ,50.28665028665029,
2522,CDS,1196090,1197311,1,1221,argJ,50.28665028665029,
2523,gene,1197325,1198102,1,777,argB,51.86615186615187,
2524,CDS,1197325,1198102,1,777,argB,51.86615186615187,
2525,gene,1198098,1199256,1,1158,argD,50.431778929188255,
2526,CDS,1198098,1199256,1,1158,argD,50.431778929188255,
2527,gene,1199326,1200388,1,1062,carA,53.10734463276836,
2528,CDS,1199326,1200388,1,1062,carA,53.10734463276836,
2529,gene,1200380,1203473,1,3093,carB,53.0552861299709,
2530,CDS,1200380,1203473,1,3093,carB,53.0552861299709,
2531,gene,1203460,1204420,1,960,argF,51.5625,
2532,CDS,1203460,1204420,1,960,argF,51.5625,
2533,gene,1204505,1204685,1,180,yjzC,47.77777777777778,
2534,CDS,1204505,1204685,1,180,yjzC,47.77777777777778,
2535,gene,1204730,1204916,-1,186,yjzD,63.97849462365591,
2536,CDS,1204730,1204916,-1,186,yjzD,63.97849462365591,
2537,gene,1205164,1205899,1,735,yjaU,57.14285714285714,
2538,CDS,1205164,1205899,1,735,yjaU,57.14285714285714,
2539,gene,1205980,1206538,1,558,yjaV,61.111111111111114,
2540,CDS,1205980,1206538,1,558,yjaV,61.111111111111114,
2541,gene,1206628,1207582,1,954,med,56.91823899371069,
2542,CDS,1206628,1207582,1,954,med,56.91823899371069,
2543,gene,1207596,1207788,1,192,comZ,58.333333333333336,
2544,CDS,1207596,1207788,1,192,comZ,58.333333333333336,
2545,gene,1207817,1208057,-1,240,yjzB,58.333333333333336,
2546,CDS,1207817,1208057,-1,240,yjzB,58.333333333333336,
2547,gene,1208221,1209160,1,939,fabHA,53.78061767838126,
2548,CDS,1208221,1209160,1,939,fabHA,53.78061767838126,
2549,gene,1209182,1210424,1,1242,fabF,53.3011272141707,
2550,CDS,1209182,1210424,1,1242,fabF,53.3011272141707,
2551,gene,1210499,1211285,1,786,yjaZ,56.99745547073791,
2552,CDS,1210499,1211285,1,786,yjaZ,56.99745547073791,
2553,gene,1211476,1212463,1,987,appD,54.1033434650456,
2554,CDS,1211476,1212463,1,987,appD,54.1033434650456,
2555,gene,1212459,1213449,1,990,appF,54.04040404040404,
2556,CDS,1212459,1213449,1,990,appF,54.04040404040404,
2557,gene,1213536,1214001,1,465,appAn,58.70967741935483,
2558,misc_feature,1213536,1214001,1,465,appAn,58.70967741935483,
2559,gene,1214000,1215167,1,1167,appAc,60.411311053984576,
2560,misc_feature,1214000,1215167,1,1167,appAc,60.411311053984576,
2561,gene,1215242,1216193,1,951,appB,58.0441640378549,
2562,CDS,1215242,1216193,1,951,appB,58.0441640378549,
2563,gene,1216209,1217121,1,912,appC,56.79824561403509,
2564,CDS,1216209,1217121,1,912,appC,56.79824561403509,
2565,gene,1217325,1218078,1,753,yjbA,58.16733067729084,
2566,CDS,1217325,1218078,1,753,yjbA,58.16733067729084,
2567,gene,1218112,1219105,-1,993,trpS,54.68277945619335,
2568,CDS,1218112,1219105,-1,993,trpS,54.68277945619335,
2569,gene,1219163,1219378,-1,215,tboWA,53.02325581395348,
2570,misc_RNA,1219163,1219378,-1,215,tboWA,53.02325581395348,
2571,gene,1219848,1221486,1,1638,oppA,58.54700854700855,
2572,CDS,1219848,1221486,1,1638,oppA,58.54700854700855,
2573,gene,1221593,1222529,1,936,oppB,55.34188034188035,
2574,CDS,1221593,1222529,1,936,oppB,55.34188034188035,
2575,gene,1222532,1223450,1,918,oppC,55.22875816993464,
2576,CDS,1222532,1223450,1,918,oppC,55.22875816993464,
2577,gene,1223454,1224531,1,1077,oppD,52.92479108635098,
2578,CDS,1223454,1224531,1,1077,oppD,52.92479108635098,
2579,gene,1224532,1225450,1,918,oppF,55.119825708061,
2580,CDS,1224532,1225450,1,918,oppF,55.119825708061,
2581,gene,1225556,1226774,1,1218,yjbB,54.35139573070607,
2582,CDS,1225556,1226774,1,1218,yjbB,54.35139573070607,
2583,gene,1226937,1227516,1,579,yjbC,61.83074265975821,
2584,CDS,1226937,1227516,1,579,yjbC,61.83074265975821,
2585,gene,1227696,1228092,1,396,spxA,58.080808080808076,
2586,CDS,1227696,1228092,1,396,spxA,58.080808080808076,
2587,gene,1228134,1228791,-1,657,yjbE,53.57686453576864,
2588,CDS,1228134,1228791,-1,657,yjbE,53.57686453576864,
2589,gene,1228960,1229101,1,141,BSU_11515,63.12056737588653,
2590,CDS,1228960,1229101,1,141,BSU_11515,63.12056737588653,
2591,gene,1229067,1229724,1,657,mecA,59.96955859969558,
2592,CDS,1229067,1229724,1,657,mecA,59.96955859969558,
2593,gene,1229718,1229841,-1,123,BSU_11525,65.04065040650406,
2594,CDS,1229718,1229841,-1,123,BSU_11525,65.04065040650406,
2595,gene,1229914,1231036,1,1122,coiA,55.080213903743314,
2596,CDS,1229914,1231036,1,1122,coiA,55.080213903743314,
2597,gene,1231082,1233095,1,2013,pepF,56.58221559860904,
2598,CDS,1231082,1233095,1,2013,pepF,56.58221559860904,
2599,gene,1233132,1233300,-1,168,yizD,61.904761904761905,
2600,CDS,1233132,1233300,-1,168,yizD,61.904761904761905,
2601,gene,1233404,1233543,1,139,roxS,59.71223021582733,
2602,misc_RNA,1233404,1233543,1,139,roxS,59.71223021582733,
2603,gene,1233613,1234513,-1,900,spxH,57.88888888888889,
2604,CDS,1233613,1234513,-1,900,spxH,57.88888888888889,
2605,gene,1234509,1234908,-1,399,yjbI,52.38095238095239,
2606,CDS,1234509,1234908,-1,399,yjbI,52.38095238095239,
2607,gene,1235162,1235708,-1,546,cwlQ,53.47985347985348,
2608,CDS,1235162,1235708,-1,546,cwlQ,53.47985347985348,
2609,gene,1235911,1236484,-1,573,yjbK,58.46422338568935,
2610,CDS,1235911,1236484,-1,573,yjbK,58.46422338568935,
2611,gene,1236608,1236977,1,369,yjbL,60.43360433604336,
2612,CDS,1236608,1236977,1,369,yjbL,60.43360433604336,
2613,gene,1237005,1237641,1,636,relP,54.55974842767296,
2614,CDS,1237005,1237641,1,636,relP,54.55974842767296,
2615,gene,1237659,1238460,1,801,ppnKA,54.43196004993758,
2616,CDS,1237659,1238460,1,801,ppnKA,54.43196004993758,
2617,gene,1238522,1239374,1,852,yjbO,50.23474178403756,
2618,CDS,1238522,1239374,1,852,yjbO,50.23474178403756,
2619,gene,1239386,1240121,-1,735,prpE,53.46938775510204,
2620,CDS,1239386,1240121,-1,735,prpE,53.46938775510204,
2621,gene,1240355,1242200,1,1845,kefQ,56.15176151761517,
2622,CDS,1240355,1242200,1,1845,kefQ,56.15176151761517,
2623,gene,1242261,1242370,1,109,tswA,55.04587155963303,
2624,misc_RNA,1242261,1242370,1,109,tswA,55.04587155963303,
2625,gene,1242448,1243159,1,711,tenA,51.19549929676512,
2626,CDS,1242448,1243159,1,711,tenA,51.19549929676512,
2627,gene,1243133,1243751,1,618,tenI,51.7799352750809,
2628,CDS,1243133,1243751,1,618,tenI,51.7799352750809,
2629,gene,1243734,1244844,1,1110,thiO,51.53153153153153,
2630,CDS,1243734,1244844,1,1110,thiO,51.53153153153153,
2631,gene,1244843,1245044,1,201,thiS,59.20398009950249,
2632,CDS,1244843,1245044,1,201,thiS,59.20398009950249,
2633,gene,1245040,1245811,1,771,thiG,50.97276264591439,
2634,CDS,1245040,1245811,1,771,thiG,50.97276264591439,
2635,gene,1245807,1246818,1,1011,thiF,48.96142433234421,
2636,CDS,1245807,1246818,1,1011,thiF,48.96142433234421,
2637,gene,1246836,1247652,1,816,thiD,50.49019607843137,
2638,CDS,1246836,1247652,1,816,thiD,50.49019607843137,
2639,gene,1247787,1248564,1,777,fabI,51.86615186615187,
2640,CDS,1247787,1248564,1,777,fabI,51.86615186615187,
2641,gene,1248664,1249348,1,684,cotO,51.31578947368421,
2642,CDS,1248664,1249348,1,684,cotO,51.31578947368421,
2643,gene,1249441,1249888,-1,447,cotZ,57.71812080536913,
2644,CDS,1249441,1249888,-1,447,cotZ,57.71812080536913,
2645,gene,1250015,1250504,-1,489,cotY,54.601226993865026,
2646,CDS,1250015,1250504,-1,489,cotY,54.601226993865026,
2647,gene,1250655,1251174,-1,519,cotX,58.38150289017341,
2648,CDS,1250655,1251174,-1,519,cotX,58.38150289017341,
2649,gene,1251272,1251590,-1,318,cotW,64.15094339622641,
2650,CDS,1251272,1251590,-1,318,cotW,64.15094339622641,
2651,gene,1251630,1252017,-1,387,cotV,59.9483204134367,
2652,CDS,1251630,1252017,-1,387,cotV,59.9483204134367,
2653,gene,1252176,1252533,1,357,yjcA,49.299719887955185,
2654,CDS,1252176,1252533,1,357,yjcA,49.299719887955185,
2655,gene,1252557,1252791,-1,234,BSU_11798,61.53846153846154,
2656,misc_feature,1252557,1252791,-1,234,BSU_11798,61.53846153846154,
2657,gene,1252814,1253021,1,207,yjzK,62.31884057971014,
2658,CDS,1252814,1253021,1,207,yjzK,62.31884057971014,
2659,gene,1252857,1253073,1,216,yjcB,57.870370370370374,
2660,CDS,1252857,1253073,1,216,yjcB,57.870370370370374,
2661,gene,1253102,1253252,1,150,yjcZ,49.333333333333336,
2662,CDS,1253102,1253252,1,150,yjcZ,49.333333333333336,
2663,gene,1253384,1253639,1,255,spoVIF,64.31372549019608,
2664,CDS,1253384,1253639,1,255,spoVIF,64.31372549019608,
2665,gene,1253712,1255992,-1,2280,yjcD,53.59649122807018,
2666,CDS,1253712,1255992,-1,2280,yjcD,53.59649122807018,
2667,gene,1256108,1256363,1,255,yjzE,60.78431372549019,
2668,CDS,1256108,1256363,1,255,yjzE,60.78431372549019,
2669,gene,1256435,1256858,-1,423,yjcF,52.4822695035461,
2670,CDS,1256435,1256858,-1,423,yjcF,52.4822695035461,
2671,gene,1256861,1257377,-1,516,yjcG,56.395348837209305,
2672,CDS,1256861,1257377,-1,516,yjcG,56.395348837209305,
2673,gene,1257413,1258136,-1,723,yjcH,54.08022130013831,
2674,CDS,1257413,1258136,-1,723,yjcH,54.08022130013831,
2675,gene,1258303,1258424,1,121,mswA,53.71900826446281,
2676,misc_RNA,1258303,1258424,1,121,mswA,53.71900826446281,
2677,gene,1258491,1259613,1,1122,metI,52.04991087344028,
2678,CDS,1258491,1259613,1,1122,metI,52.04991087344028,
2679,gene,1259605,1260778,1,1173,metC,49.10485933503836,
2680,CDS,1259605,1260778,1,1173,metC,49.10485933503836,
2681,gene,1260810,1261356,-1,546,yjcK,57.692307692307686,
2682,CDS,1260810,1261356,-1,546,yjcK,57.692307692307686,
2683,gene,1261425,1262616,-1,1191,yjcL,54.072208228379516,
2684,CDS,1261425,1262616,-1,1191,yjcL,54.072208228379516,
2685,gene,1262788,1262861,1,73,trnSL-Val2,41.0958904109589,
2686,tRNA,1262788,1262861,1,73,trnSL-Val2,41.0958904109589,
2687,gene,1263701,1264931,-1,1230,yjcM,68.69918699186992,
2688,CDS,1263701,1264931,-1,1230,yjcM,68.69918699186992,
2689,gene,1265056,1265377,1,321,yjcN,63.55140186915887,
2690,CDS,1265056,1265377,1,321,yjcN,63.55140186915887,
2691,gene,1265529,1265661,1,132,yjzF,57.57575757575758,
2692,CDS,1265529,1265661,1,132,yjzF,57.57575757575758,
2693,gene,1265676,1265850,1,174,yjzG,60.91954022988506,
2694,CDS,1265676,1265850,1,174,yjzG,60.91954022988506,
2695,gene,1265886,1266348,1,462,yjcO,56.27705627705628,
2696,CDS,1265886,1266348,1,462,yjcO,56.27705627705628,
2697,gene,1266613,1267117,1,504,yjcP,70.43650793650794,
2698,CDS,1266613,1267117,1,504,yjcP,70.43650793650794,
2699,gene,1267128,1267413,1,285,yjcQ,67.36842105263158,
2700,CDS,1267128,1267413,1,285,yjcQ,67.36842105263158,
2701,gene,1267573,1268101,1,528,yjcR,55.871212121212125,
2702,CDS,1267573,1268101,1,528,yjcR,55.871212121212125,
2703,gene,1268274,1268592,1,318,yjcS,65.40880503144653,
2704,CDS,1268274,1268592,1,318,yjcS,65.40880503144653,
2705,gene,1268828,1269584,1,756,yjdA,61.37566137566137,
2706,CDS,1268828,1269584,1,756,yjdA,61.37566137566137,
2707,gene,1269732,1270080,-1,348,yjdB,64.65517241379311,
2708,CDS,1269732,1270080,-1,348,yjdB,64.65517241379311,
2709,gene,1270630,1272577,1,1947,manR,59.630200308166415,
2710,CDS,1270630,1272577,1,1947,manR,59.630200308166415,
2711,gene,1272724,1274677,1,1953,manP,53.96825396825397,
2712,CDS,1272724,1274677,1,1953,manP,53.96825396825397,
2713,gene,1274691,1275639,1,948,manA,56.540084388185655,
2714,CDS,1274691,1275639,1,948,manA,56.540084388185655,
2715,gene,1275808,1276291,1,483,yjdF,60.45548654244306,
2716,CDS,1275808,1276291,1,483,yjdF,60.45548654244306,
2717,gene,1276336,1276843,-1,507,yjdG,62.1301775147929,
2718,CDS,1276336,1276843,-1,507,yjdG,62.1301775147929,
2719,gene,1277061,1277457,-1,396,yjdH,57.82828282828283,
2720,CDS,1277061,1277457,-1,396,yjdH,57.82828282828283,
2721,gene,1277685,1278165,1,480,trnE,58.54166666666667,
2722,CDS,1277685,1278165,1,480,trnE,58.54166666666667,
2723,gene,1278204,1278399,-1,195,yjzH,60.0,
2724,CDS,1278204,1278399,-1,195,yjzH,60.0,
2725,gene,1278564,1278894,-1,330,yjdJ,63.030303030303024,
2726,CDS,1278564,1278894,-1,330,yjdJ,63.030303030303024,
2727,gene,1279513,1280503,-1,990,ctaO,54.44444444444444,
2728,CDS,1279513,1280503,-1,990,ctaO,54.44444444444444,
2729,gene,1280625,1280874,-1,249,cotT,51.40562248995983,
2730,CDS,1280625,1280874,-1,249,cotT,51.40562248995983,
2731,gene,1281127,1282531,1,1404,pdaC,61.25356125356125,
2732,CDS,1281127,1282531,1,1404,pdaC,61.25356125356125,
2733,gene,1282570,1283044,-1,474,yjfA,56.540084388185655,
2734,CDS,1282570,1283044,-1,474,yjfA,56.540084388185655,
2735,gene,1283168,1283336,-1,168,yjfB,58.92857142857143,
2736,CDS,1283168,1283336,-1,168,yjfB,58.92857142857143,
2737,gene,1283462,1284362,1,900,yjfC,56.44444444444444,
2738,CDS,1283462,1284362,1,900,yjfC,56.44444444444444,
2739,gene,1284370,1284769,-1,399,yjgA,53.88471177944862,
2740,CDS,1284370,1284769,-1,399,yjgA,53.88471177944862,
2741,gene,1284869,1285445,-1,576,yjgB,52.77777777777778,
2742,CDS,1284869,1285445,-1,576,yjgB,52.77777777777778,
2743,gene,1285590,1288548,1,2958,yjgC,51.014198782961465,
2744,CDS,1285590,1288548,1,2958,yjgC,51.014198782961465,
2745,gene,1288540,1289101,1,561,yjgD,54.72370766488414,
2746,CDS,1288540,1289101,1,561,yjgD,54.72370766488414,
2747,gene,1289297,1289939,1,642,yjhA,63.39563862928349,
2748,CDS,1289297,1289939,1,642,yjhA,63.39563862928349,
2749,gene,1290017,1290644,1,627,yjhB,49.441786283891545,
2750,CDS,1290017,1290644,1,627,yjhB,49.441786283891545,
2751,gene,1290674,1290953,-1,279,yjiA,60.93189964157706,
2752,CDS,1290674,1290953,-1,279,yjiA,60.93189964157706,
2753,gene,1291343,1292534,1,1191,cypE,53.064651553316544,
2754,CDS,1291343,1292534,1,1191,cypE,53.064651553316544,
2755,gene,1292556,1293735,1,1179,ppuG,53.68956743002544,
2756,CDS,1292556,1293735,1,1179,ppuG,53.68956743002544,
2757,gene,1293775,1293964,-1,189,yjzI,60.317460317460316,
2758,CDS,1293775,1293964,-1,189,yjzI,60.317460317460316,
2759,gene,1294137,1294950,1,813,yjjA,49.69249692496925,
2760,CDS,1294137,1294950,1,813,yjjA,49.69249692496925,
2761,gene,1294995,1295748,-1,753,yjkA,53.12084993359893,
2762,CDS,1294995,1295748,-1,753,yjkA,53.12084993359893,
2763,gene,1295747,1296500,-1,753,yjkB,50.73041168658698,
2764,CDS,1295747,1296500,-1,753,yjkB,50.73041168658698,
2765,gene,1296619,1297594,-1,975,yjlA,53.333333333333336,
2766,CDS,1296619,1297594,-1,975,yjlA,53.333333333333336,
2767,gene,1297725,1298223,1,498,yjlB,47.99196787148594,
2768,CDS,1297725,1298223,1,498,yjlB,47.99196787148594,
2769,gene,1298611,1299034,1,423,yjlC,56.50118203309693,
2770,CDS,1298611,1299034,1,423,yjlC,56.50118203309693,
2771,gene,1299073,1300252,1,1179,ndh,55.04664970313825,
2772,CDS,1299073,1300252,1,1179,ndh,55.04664970313825,
2773,gene,1300449,1301871,1,1422,uxaC,56.75105485232067,
2774,CDS,1300449,1301871,1,1422,uxaC,56.75105485232067,
2775,gene,1301938,1303318,1,1380,exuM,55.362318840579704,
2776,CDS,1301938,1303318,1,1380,exuM,55.362318840579704,
2777,gene,1303422,1304436,1,1014,yjmC,51.28205128205128,
2778,CDS,1303422,1304436,1,1014,yjmC,51.28205128205128,
2779,gene,1304441,1305461,1,1020,yjmD,49.31372549019608,
2780,CDS,1304441,1305461,1,1020,yjmD,49.31372549019608,
2781,gene,1305485,1306565,1,1080,uxuA,52.77777777777778,
2782,CDS,1305485,1306565,1,1080,uxuA,52.77777777777778,
2783,gene,1306561,1307398,1,837,uxuB,47.909199522102746,
2784,CDS,1306561,1307398,1,837,uxuB,47.909199522102746,
2785,gene,1307445,1308714,1,1269,exuT,50.985027580772254,
2786,CDS,1307445,1308714,1,1269,exuT,50.985027580772254,
2787,gene,1308801,1309803,1,1002,exuR,56.187624750499,
2788,CDS,1308801,1309803,1,1002,exuR,56.187624750499,
2789,gene,1309879,1311322,1,1443,uxaB,57.1032571032571,
2790,CDS,1309879,1311322,1,1443,uxaB,57.1032571032571,
2791,gene,1311318,1312812,1,1494,uxaA,53.81526104417671,
2792,CDS,1311318,1312812,1,1494,uxaA,53.81526104417671,
2793,gene,1312850,1313615,-1,765,yjnA,54.771241830065364,
2794,CDS,1312850,1313615,-1,765,yjnA,54.771241830065364,
2795,gene,1313839,1314304,-1,465,yjoA,55.26881720430108,
2796,CDS,1313839,1314304,-1,465,yjoA,55.26881720430108,
2797,gene,1314452,1315724,1,1272,yjoB,56.132075471698116,
2798,CDS,1314452,1315724,1,1272,yjoB,56.132075471698116,
2799,gene,1315868,1317005,1,1137,rapA,60.59806508355321,
2800,CDS,1315868,1317005,1,1137,rapA,60.59806508355321,
2801,gene,1316994,1317129,1,135,phrA,56.2962962962963,
2802,CDS,1316994,1317129,1,135,phrA,56.2962962962963,
2803,gene,1317156,1317414,-1,258,yjpA,54.65116279069767,
2804,CDS,1317156,1317414,-1,258,yjpA,54.65116279069767,
2805,gene,1317534,1318488,1,954,xlyB,50.73375262054507,
2806,CDS,1317534,1318488,1,954,xlyB,50.73375262054507,
2807,gene,1318527,1318905,-1,378,yjqA,56.08465608465608,
2808,CDS,1318527,1318905,-1,378,yjqA,56.08465608465608,
2809,gene,1319010,1319613,1,603,pghB,52.90215588723052,
2810,CDS,1319010,1319613,1,603,pghB,52.90215588723052,
2811,gene,1319689,1320526,1,837,xpdC,51.25448028673835,
2812,CDS,1319689,1320526,1,837,xpdC,51.25448028673835,
2813,gene,1320569,1321166,-1,597,xkdA,54.941373534338354,
2814,CDS,1320569,1321166,-1,597,xkdA,54.941373534338354,
2815,gene,1321328,1321670,-1,342,xre,56.72514619883041,
2816,CDS,1321328,1321670,-1,342,xre,56.72514619883041,
2817,gene,1321847,1322027,1,180,yjzJ,55.00000000000001,
2818,CDS,1321847,1322027,1,180,yjzJ,55.00000000000001,
2819,gene,1322013,1322850,1,837,xkdB,53.882915173237755,
2820,CDS,1322013,1322850,1,837,xkdB,53.882915173237755,
2821,gene,1322749,1323550,1,801,xkdC,52.43445692883895,
2822,CDS,1322749,1323550,1,801,xkdC,52.43445692883895,
2823,gene,1323549,1323717,1,168,ykzK,55.952380952380956,
2824,CDS,1323549,1323717,1,168,ykzK,55.952380952380956,
2825,gene,1323801,1324152,1,351,xkdD,54.41595441595442,
2826,CDS,1323801,1324152,1,351,xkdD,54.41595441595442,
2827,gene,1324148,1324355,1,207,xtrA,54.589371980676326,
2828,CDS,1324148,1324355,1,207,xtrA,54.589371980676326,
2829,gene,1324470,1324980,1,510,xpf,57.05882352941176,
2830,CDS,1324470,1324980,1,510,xpf,57.05882352941176,
2831,gene,1325095,1325893,1,798,xtmA,57.5187969924812,
2832,CDS,1325095,1325893,1,798,xtmA,57.5187969924812,
2833,gene,1325889,1327191,1,1302,xtmB,53.686635944700456,
2834,CDS,1325889,1327191,1,1302,xtmB,53.686635944700456,
2835,gene,1327194,1328682,1,1488,xkdE,53.696236559139784,
2836,CDS,1327194,1328682,1,1488,xkdE,53.696236559139784,
2837,gene,1328701,1329529,1,828,xkdF,50.84541062801933,
2838,CDS,1328701,1329529,1,828,xkdF,50.84541062801933,
2839,gene,1329554,1330490,1,936,xkdG,52.243589743589745,
2840,CDS,1329554,1330490,1,936,xkdG,52.243589743589745,
2841,gene,1330511,1330895,1,384,ykzL,49.47916666666667,
2842,CDS,1330511,1330895,1,384,ykzL,49.47916666666667,
2843,gene,1330891,1331248,1,357,xkdH,52.66106442577031,
2844,CDS,1330891,1331248,1,357,xkdH,52.66106442577031,
2845,gene,1331244,1331730,1,486,xkdI,50.82304526748971,
2846,CDS,1331244,1331730,1,486,xkdI,50.82304526748971,
2847,gene,1331742,1332183,1,441,xkdJ,50.34013605442177,
2848,CDS,1331742,1332183,1,441,xkdJ,50.34013605442177,
2849,gene,1332186,1332405,1,219,ykzM,55.70776255707762,
2850,CDS,1332186,1332405,1,219,ykzM,55.70776255707762,
2851,gene,1332401,1333802,1,1401,xkdK,53.53319057815846,
2852,CDS,1332401,1333802,1,1401,xkdK,53.53319057815846,
2853,gene,1333803,1334247,1,444,xkdM,54.054054054054056,
2854,CDS,1333803,1334247,1,444,xkdM,54.054054054054056,
2855,gene,1334338,1334785,1,447,xkdN,62.41610738255034,
2856,CDS,1334338,1334785,1,447,xkdN,62.41610738255034,
2857,gene,1334814,1334964,1,150,xkzB,65.33333333333333,
2858,CDS,1334814,1334964,1,150,xkzB,65.33333333333333,
2859,gene,1334965,1338964,1,3999,xkdO,57.28932233058265,
2860,CDS,1334965,1338964,1,3999,xkdO,57.28932233058265,
2861,gene,1338956,1339616,1,660,xkdP,57.27272727272727,
2862,CDS,1338956,1339616,1,660,xkdP,57.27272727272727,
2863,gene,1339631,1340609,1,978,xkdQ,52.14723926380368,
2864,CDS,1339631,1340609,1,978,xkdQ,52.14723926380368,
2865,gene,1340608,1340875,1,267,xkdR,51.31086142322098,
2866,CDS,1340608,1340875,1,267,xkdR,51.31086142322098,
2867,gene,1340931,1341357,1,426,xkdS,55.39906103286385,
2868,CDS,1340931,1341357,1,426,xkdS,55.39906103286385,
2869,gene,1341349,1342396,1,1047,xkdT,52.62655205348615,
2870,CDS,1341349,1342396,1,1047,xkdT,52.62655205348615,
2871,gene,1342379,1342958,1,579,xkdU,51.46804835924007,
2872,CDS,1342379,1342958,1,579,xkdU,51.46804835924007,
2873,gene,1342954,1343227,1,273,xkzA,55.67765567765568,
2874,CDS,1342954,1343227,1,273,xkzA,55.67765567765568,
2875,gene,1343229,1345293,1,2064,xkdV,61.82170542635659,
2876,CDS,1343229,1345293,1,2064,xkdV,61.82170542635659,
2877,gene,1345304,1345634,1,330,xkdW,54.848484848484844,
2878,CDS,1345304,1345634,1,330,xkdW,54.848484848484844,
2879,gene,1345630,1345795,1,165,xkdX,57.57575757575758,
2880,CDS,1345630,1345795,1,165,xkdX,57.57575757575758,
2881,gene,1345838,1346678,1,840,xepA,52.73809523809524,
2882,CDS,1345838,1346678,1,840,xepA,52.73809523809524,
2883,gene,1346730,1347000,1,270,xhlA,52.59259259259259,
2884,CDS,1346730,1347000,1,270,xhlA,52.59259259259259,
2885,gene,1347012,1347276,1,264,xhlB,56.060606060606055,
2886,CDS,1347012,1347276,1,264,xhlB,56.060606060606055,
2887,gene,1347288,1348182,1,894,xlyA,52.9082774049217,
2888,CDS,1347288,1348182,1,894,xlyA,52.9082774049217,
2889,gene,1348218,1348356,-1,138,spoIISC,57.2463768115942,
2890,CDS,1348218,1348356,-1,138,spoIISC,57.2463768115942,
2891,gene,1348441,1348612,-1,171,spoIISB,55.55555555555556,
2892,CDS,1348441,1348612,-1,171,spoIISB,55.55555555555556,
2893,gene,1348611,1349358,-1,747,spoIISA,57.831325301204814,
2894,CDS,1348611,1349358,-1,747,spoIISA,57.831325301204814,
2895,gene,1349467,1350469,-1,1002,pitB,54.890219560878236,
2896,CDS,1349467,1350469,-1,1002,pitB,54.890219560878236,
2897,gene,1350481,1351099,-1,618,ykaA,64.07766990291263,
2898,CDS,1350481,1351099,-1,618,ykaA,64.07766990291263,
2899,gene,1351374,1352691,-1,1317,steT,54.51784358390282,
2900,CDS,1351374,1352691,-1,1317,steT,54.51784358390282,
2901,gene,1353079,1354030,1,951,mhqA,53.10199789695058,
2902,CDS,1353079,1354030,1,951,mhqA,53.10199789695058,
2903,gene,1354130,1354277,1,147,BSU_12875,66.66666666666666,
2904,CDS,1354130,1354277,1,147,BSU_12875,66.66666666666666,
2905,gene,1354284,1356435,1,2151,ykcB,53.69595536959554,
2906,CDS,1354284,1356435,1,2151,ykcB,53.69595536959554,
2907,gene,1356446,1357418,1,972,ykcC,56.99588477366255,
2908,CDS,1356446,1357418,1,972,ykcC,56.99588477366255,
2909,gene,1357935,1359285,-1,1350,htrA,55.407407407407405,
2910,CDS,1357935,1359285,-1,1350,htrA,55.407407407407405,
2911,gene,1359453,1360272,1,819,proCC,53.35775335775336,
2912,CDS,1359453,1360272,1,819,proCC,53.35775335775336,
2913,gene,1360400,1361225,1,825,dppA,51.15151515151515,
2914,CDS,1360400,1361225,1,825,dppA,51.15151515151515,
2915,gene,1361241,1362168,1,927,dppB,53.61380798274003,
2916,CDS,1361241,1362168,1,927,dppB,53.61380798274003,
2917,gene,1362173,1363136,1,963,dppC,50.05192107995846,
2918,CDS,1362173,1363136,1,963,dppC,50.05192107995846,
2919,gene,1363140,1364148,1,1008,dppD,48.01587301587302,
2920,CDS,1363140,1364148,1,1008,dppD,48.01587301587302,
2921,gene,1364150,1365800,1,1650,dppE,55.333333333333336,
2922,CDS,1364150,1365800,1,1650,dppE,55.333333333333336,
2923,gene,1365887,1366847,1,960,ldcA,50.0,
2924,CDS,1365887,1366847,1,960,ldcA,50.0,
2925,gene,1366843,1367944,1,1101,aeeB,49.77293369663942,
2926,CDS,1366843,1367944,1,1101,aeeB,49.77293369663942,
2927,gene,1367940,1368831,1,891,eepC,52.52525252525253,
2928,CDS,1367940,1368831,1,891,eepC,52.52525252525253,
2929,gene,1368843,1369833,1,990,ykfD,49.696969696969695,
2930,CDS,1368843,1369833,1,990,ykfD,49.696969696969695,putative cell wall oligopeptide ABC transporter (ATP binding protein)
2931,gene,1369875,1370925,-1,1050,pgl,54.38095238095239,
2932,CDS,1369875,1370925,-1,1050,pgl,54.38095238095239,
2933,gene,1371014,1371875,-1,861,ddaH,55.63298490127758,
2934,CDS,1371014,1371875,-1,861,ddaH,55.63298490127758,
2935,gene,1372034,1372553,1,519,ykhA,53.94990366088632,
2936,CDS,1372034,1372553,1,519,ykhA,53.94990366088632,
2937,gene,1372791,1373991,1,1200,hmpA,55.833333333333336,
2938,CDS,1372791,1373991,1,1200,hmpA,55.833333333333336,
2939,gene,1374067,1374292,-1,225,ykzH,52.44444444444445,
2940,CDS,1374067,1374292,-1,225,ykzH,52.44444444444445,
2941,gene,1374436,1375168,1,732,ykjA,56.14754098360656,
2942,CDS,1374436,1375168,1,732,ykjA,56.14754098360656,
2943,gene,1375259,1375787,1,528,ykkA,53.40909090909091,
2944,CDS,1375259,1375787,1,528,ykkA,53.40909090909091,
2945,gene,1375776,1376295,1,519,ykkB,52.215799614643544,
2946,CDS,1375776,1376295,1,519,ykkB,52.215799614643544,
2947,gene,1376327,1376439,1,112,gdwA,51.78571428571429,
2948,misc_RNA,1376327,1376439,1,112,gdwA,51.78571428571429,
2949,gene,1376516,1376855,1,339,gdnC,50.737463126843664,
2950,CDS,1376516,1376855,1,339,gdnC,50.737463126843664,
2951,gene,1376854,1377172,1,318,gdnD,51.886792452830186,
2952,CDS,1376854,1377172,1,318,gdnD,51.886792452830186,
2953,gene,1377242,1378145,1,903,purU,51.93798449612403,
2954,CDS,1377242,1378145,1,903,purU,51.93798449612403,
2955,gene,1378232,1378443,1,211,pswB,49.28909952606635,
2956,misc_RNA,1378232,1378443,1,211,pswB,49.28909952606635,
2957,gene,1378495,1379593,1,1098,proB,53.36976320582878,
2958,CDS,1378495,1379593,1,1098,proB,53.36976320582878,
2959,gene,1379604,1380852,1,1248,proA,52.644230769230774,
2960,CDS,1379604,1380852,1,1248,proA,52.644230769230774,
2961,gene,1380977,1381403,1,426,ohrA,51.64319248826291,
2962,CDS,1380977,1381403,1,426,ohrA,51.64319248826291,
2963,gene,1381433,1381877,-1,444,ohrR,59.45945945945946,
2964,CDS,1381433,1381877,-1,444,ohrR,59.45945945945946,
2965,gene,1382019,1382430,1,411,ohrB,53.771289537712896,
2966,CDS,1382019,1382430,1,411,ohrB,53.771289537712896,
2967,gene,1382456,1382627,1,171,ykzN,52.63157894736842,
2968,CDS,1382456,1382627,1,171,ykzN,52.63157894736842,
2969,gene,1382676,1383147,-1,471,guaN,52.4416135881104,
2970,CDS,1382676,1383147,-1,471,guaN,52.4416135881104,
2971,gene,1383319,1385608,-1,2289,metE,54.74006116207951,
2972,CDS,1383319,1385608,-1,2289,metE,54.74006116207951,
2973,gene,1385735,1385891,-1,156,mswB,48.717948717948715,
2974,misc_RNA,1385735,1385891,-1,156,mswB,48.717948717948715,
2975,gene,1386023,1386983,-1,960,ispA,52.916666666666664,
2976,CDS,1386023,1386983,-1,960,ispA,52.916666666666664,
2977,gene,1387205,1388039,1,834,rsbRB,58.752997601918466,
2978,CDS,1387205,1388039,1,834,rsbRB,58.752997601918466,
2979,gene,1388069,1388834,-1,765,thiX,53.72549019607843,
2980,CDS,1388069,1388834,-1,765,thiX,53.72549019607843,
2981,gene,1388808,1390452,-1,1644,thiW,53.284671532846716,
2982,CDS,1388808,1390452,-1,1644,thiW,53.284671532846716,
2983,gene,1390438,1391038,-1,600,thiV,52.166666666666664,
2984,CDS,1390438,1391038,-1,600,thiV,52.166666666666664,
2985,gene,1391039,1391642,-1,603,thiU,52.57048092868989,
2986,CDS,1391039,1391642,-1,603,thiU,52.57048092868989,
2987,gene,1391738,1391851,-1,113,tswB,47.78761061946903,
2988,misc_RNA,1391738,1391851,-1,113,tswB,47.78761061946903,
2989,gene,1391952,1392639,1,687,ykoG,53.275109170305676,
2990,CDS,1391952,1392639,1,687,ykoG,53.275109170305676,
2991,gene,1392642,1394007,1,1365,ykoH,53.772893772893774,
2992,CDS,1392642,1394007,1,1365,ykoH,53.772893772893774,
2993,gene,1394003,1394684,1,681,ykoI,58.590308370044056,
2994,CDS,1394003,1394684,1,681,ykoI,58.590308370044056,
2995,gene,1394775,1395288,1,513,ykoJ,58.47953216374269,
2996,CDS,1394775,1395288,1,513,ykoJ,58.47953216374269,
2997,gene,1395370,1395508,1,138,ykzD,60.86956521739131,
2998,CDS,1395370,1395508,1,138,ykzD,60.86956521739131,
2999,gene,1395621,1395775,1,154,swmG,54.54545454545454,
3000,misc_RNA,1395621,1395775,1,154,swmG,54.54545454545454,
3001,gene,1396012,1397368,1,1356,mgtE,57.15339233038348,
3002,CDS,1396012,1397368,1,1356,mgtE,57.15339233038348,
3003,gene,1397410,1397743,-1,333,tnrA,57.35735735735735,
3004,CDS,1397410,1397743,-1,333,tnrA,57.35735735735735,
3005,gene,1397937,1398093,1,156,ykzB,60.256410256410255,
3006,CDS,1397937,1398093,1,156,ykzB,60.256410256410255,
3007,gene,1398180,1398363,1,183,ykoL,69.39890710382514,
3008,CDS,1398180,1398363,1,183,ykoL,69.39890710382514,
3009,gene,1398495,1398960,1,465,ykoM,57.41935483870968,
3010,CDS,1398495,1398960,1,465,ykoM,57.41935483870968,
3011,gene,1398974,1400096,-1,1122,ykoN,57.39750445632799,
3012,CDS,1398974,1400096,-1,1122,ykoN,57.39750445632799,
3013,gene,1400187,1400739,1,552,ykoP,61.59420289855072,
3014,CDS,1400187,1400739,1,552,ykoP,61.59420289855072,
3015,gene,1400766,1401579,-1,813,ykoQ,59.163591635916355,
3016,CDS,1400766,1401579,-1,813,ykoQ,59.163591635916355,
3017,gene,1401771,1403466,1,1695,ykoS,57.99410029498525,
3018,CDS,1401771,1403466,1,1695,ykoS,57.99410029498525,
3019,gene,1403478,1404492,1,1014,ykoT,57.100591715976336,
3020,CDS,1403478,1404492,1,1014,ykoT,57.100591715976336,
3021,gene,1404517,1406353,-1,1836,ligD,54.90196078431373,
3022,CDS,1404517,1406353,-1,1836,ligD,54.90196078431373,
3023,gene,1406356,1407292,-1,936,ligV,54.807692307692314,
3024,CDS,1406356,1407292,-1,936,ligV,54.807692307692314,
3025,gene,1407328,1409731,-1,2403,dgcW,59.675405742821475,
3026,CDS,1407328,1409731,-1,2403,dgcW,59.675405742821475,
3027,gene,1409911,1410577,1,666,ykoX,56.906906906906904,
3028,CDS,1409911,1410577,1,666,ykoX,56.906906906906904,
3029,gene,1410632,1410766,1,134,mnrW,55.223880597014926,
3030,misc_RNA,1410632,1410766,1,134,mnrW,55.223880597014926,
3031,gene,1410653,1411628,1,975,ykoY,54.35897435897436,
3032,CDS,1410653,1411628,1,975,ykoY,54.35897435897436,
3033,gene,1411891,1412647,1,756,sigI,62.698412698412696,
3034,CDS,1411891,1412647,1,756,sigI,62.698412698412696,
3035,gene,1412643,1413789,1,1146,rsgI,60.12216404886562,
3036,CDS,1412643,1413789,1,1146,rsgI,60.12216404886562,
3037,gene,1413799,1413994,-1,195,sspD,52.820512820512825,
3038,CDS,1413799,1413994,-1,195,sspD,52.820512820512825,
3039,gene,1414124,1414826,-1,702,htpK,58.97435897435898,
3040,CDS,1414124,1414826,-1,702,htpK,58.97435897435898,
3041,gene,1414996,1415893,1,897,htpX,54.06911928651059,
3042,CDS,1414996,1415893,1,897,htpX,54.06911928651059,
3043,gene,1416066,1417416,1,1350,ktrD,55.925925925925924,
3044,CDS,1416066,1417416,1,1350,ktrD,55.925925925925924,
3045,gene,1417560,1417716,1,156,ykzP,56.41025641025641,
3046,CDS,1417560,1417716,1,156,ykzP,56.41025641025641,
3047,gene,1417718,1417895,1,177,ykzE,62.71186440677966,
3048,CDS,1417718,1417895,1,177,ykzE,62.71186440677966,
3049,gene,1417937,1418960,-1,1023,ykrP,58.55327468230694,
3050,CDS,1417937,1418960,-1,1023,ykrP,58.55327468230694,
3051,gene,1419212,1421429,1,2217,kinE,59.1339648173207,
3052,CDS,1419212,1421429,1,2217,kinE,59.1339648173207,
3053,gene,1421425,1421923,1,498,ogt,51.40562248995983,
3054,CDS,1421425,1421923,1,498,ogt,51.40562248995983,
3055,gene,1422012,1422138,1,126,BSU_13545,61.111111111111114,
3056,CDS,1422012,1422138,1,126,BSU_13545,61.111111111111114,
3057,gene,1422171,1423233,-1,1062,mtnA,53.10734463276836,
3058,CDS,1422171,1423233,-1,1062,mtnA,53.10734463276836,
3059,gene,1423240,1424434,-1,1194,mtnK,55.44388609715243,
3060,CDS,1423240,1424434,-1,1194,mtnK,55.44388609715243,
3061,gene,1424526,1424683,-1,157,mswC,50.955414012738856,
3062,misc_RNA,1424526,1424683,-1,157,mswC,50.955414012738856,
3063,gene,1424766,1425546,-1,780,mtnU,55.8974358974359,
3064,CDS,1424766,1425546,-1,780,mtnU,55.8974358974359,
3065,gene,1425640,1426837,1,1197,mtnE,52.9657477025898,
3066,CDS,1425640,1426837,1,1197,mtnE,52.9657477025898,
3067,gene,1426875,1426976,1,101,mswD,48.51485148514851,
3068,misc_RNA,1426875,1426976,1,101,mswD,48.51485148514851,
3069,gene,1427060,1428278,1,1218,mtnW,51.88834154351396,
3070,CDS,1427060,1428278,1,1218,mtnW,51.88834154351396,
3071,gene,1428274,1428982,1,708,mtnX,57.909604519774014,
3072,CDS,1428274,1428982,1,708,mtnX,57.909604519774014,
3073,gene,1428939,1429569,1,630,mtnB,55.714285714285715,
3074,CDS,1428939,1429569,1,630,mtnB,55.714285714285715,
3075,gene,1429583,1430120,1,537,mtnD,58.47299813780261,
3076,CDS,1429583,1430120,1,537,mtnD,58.47299813780261,
3077,gene,1430160,1430481,-1,321,ykvA,58.87850467289719,
3078,CDS,1430160,1430481,-1,321,ykvA,58.87850467289719,
3079,gene,1430683,1430941,1,258,spo0E,59.30232558139535,
3080,CDS,1430683,1430941,1,258,spo0E,59.30232558139535,
3081,gene,1431026,1431458,1,432,eag,62.03703703703704,
3082,CDS,1431026,1431458,1,432,eag,62.03703703703704,
3083,gene,1431485,1433006,-1,1521,kinD,58.44838921761999,
3084,CDS,1431485,1433006,-1,1521,kinD,58.44838921761999,
3085,gene,1433198,1433636,1,438,mhqR,59.1324200913242,
3086,CDS,1433198,1433636,1,438,mhqR,59.1324200913242,
3087,gene,1433675,1434461,-1,786,motB,56.99745547073791,
3088,CDS,1433675,1434461,-1,786,motB,56.99745547073791,
3089,gene,1434432,1435245,-1,813,motA,55.47355473554736,
3090,CDS,1434432,1435245,-1,813,motA,55.47355473554736,
3091,gene,1435627,1437727,-1,2100,clpE,55.095238095238095,
3092,CDS,1435627,1437727,-1,2100,clpE,55.095238095238095,
3093,gene,1438091,1439135,1,1044,ykvI,56.03448275862068,
3094,CDS,1438091,1439135,1,1044,ykvI,56.03448275862068,
3095,gene,1439273,1439318,1,45,qswA,53.333333333333336,
3096,misc_RNA,1439273,1439318,1,45,qswA,53.333333333333336,
3097,gene,1439447,1440107,1,660,queC,55.00000000000001,
3098,CDS,1439447,1440107,1,660,queC,55.00000000000001,
3099,gene,1440099,1440549,1,450,queD,54.44444444444444,
3100,CDS,1440099,1440549,1,450,queD,54.44444444444444,
3101,gene,1440541,1441273,1,732,queE,53.68852459016394,
3102,CDS,1440541,1441273,1,732,queE,53.68852459016394,
3103,gene,1441290,1441788,1,498,queF,59.83935742971887,
3104,CDS,1441290,1441788,1,498,queF,59.83935742971887,
3105,gene,1442346,1442703,-1,357,ykvN,61.34453781512605,
3106,CDS,1442346,1442703,-1,357,ykvN,61.34453781512605,
3107,gene,1442871,1443618,1,747,ykvO,59.17001338688086,
3108,CDS,1442871,1443618,1,747,ykvO,59.17001338688086,
3109,gene,1444098,1445298,1,1200,ykvP,61.75000000000001,
3110,CDS,1444098,1445298,1,1200,ykvP,61.75000000000001,
3111,gene,1445313,1445541,1,228,ykzQ,66.66666666666666,
3112,CDS,1445313,1445541,1,228,ykzQ,66.66666666666666,
3113,gene,1445637,1446336,1,699,ykvQ,62.08869814020028,
3114,misc_feature,1445637,1446336,1,699,ykvQ,62.08869814020028,
3115,gene,1446316,1446568,1,252,ykzR,63.49206349206349,
3116,misc_feature,1446316,1446568,1,252,ykzR,63.49206349206349,
3117,gene,1447250,1447541,1,291,ykvR,57.0446735395189,
3118,CDS,1447250,1447541,1,291,ykvR,57.0446735395189,
3119,gene,1447661,1447847,-1,186,ykvS,67.20430107526882,
3120,CDS,1447661,1447847,-1,186,ykvS,67.20430107526882,
3121,gene,1448012,1448207,1,195,ykzS,56.92307692307692,
3122,CDS,1448012,1448207,1,195,ykzS,56.92307692307692,
3123,gene,1448505,1449132,1,627,ykvT,60.12759170653907,
3124,CDS,1448505,1449132,1,627,ykvT,60.12759170653907,cell wall hydrolase related to spore cortex-lytic enzymes
3125,gene,1449249,1450587,1,1338,ykvU,55.231689088191324,
3126,CDS,1449249,1450587,1,1338,ykvU,55.231689088191324,
3127,gene,1450637,1451135,1,498,stoA,58.032128514056225,
3128,CDS,1450637,1451135,1,498,stoA,58.032128514056225,
3129,gene,1451370,1453284,1,1914,pfeT,53.44827586206896,
3130,CDS,1451370,1453284,1,1914,pfeT,53.44827586206896,
3131,gene,1453690,1454782,1,1092,papB,54.395604395604394,
3132,CDS,1453690,1454782,1,1092,papB,54.395604395604394,
3133,gene,1455063,1456029,1,966,ykvZ,56.00414078674948,
3134,CDS,1455063,1456029,1,966,ykvZ,56.00414078674948,
3135,gene,1456091,1456958,1,867,glcT,62.399077277970015,
3136,CDS,1456091,1456958,1,867,glcT,62.399077277970015,
3137,gene,1457004,1457156,1,152,gswA,60.526315789473685,
3138,misc_RNA,1457004,1457156,1,152,gswA,60.526315789473685,
3139,gene,1457186,1459286,1,2100,ptsG,54.61904761904762,
3140,CDS,1457186,1459286,1,2100,ptsG,54.61904761904762,
3141,gene,1459383,1459650,1,267,ptsH,59.176029962546814,
3142,CDS,1459383,1459650,1,267,ptsH,59.176029962546814,
3143,gene,1459649,1461362,1,1713,ptsI,56.15878575598365,
3144,CDS,1459649,1461362,1,1713,ptsI,56.15878575598365,
3145,gene,1461452,1461692,1,240,splA,58.333333333333336,
3146,CDS,1461452,1461692,1,240,splA,58.333333333333336,
3147,gene,1461769,1462798,1,1029,splB,58.11467444120505,
3148,CDS,1461769,1462798,1,1029,splB,58.11467444120505,
3149,gene,1462812,1463493,-1,681,ykwB,56.97503671071953,
3150,CDS,1462812,1463493,-1,681,ykwB,56.97503671071953,
3151,gene,1463627,1465595,1,1968,mcpC,58.18089430894309,
3152,CDS,1463627,1465595,1,1968,mcpC,58.18089430894309,
3153,gene,1465732,1466599,1,867,ohaC,56.17070357554786,
3154,CDS,1465732,1466599,1,867,ohaC,56.17070357554786,
3155,gene,1466637,1467411,-1,774,ykwD,59.81912144702842,
3156,CDS,1466637,1467411,-1,774,ykwD,59.81912144702842,
3157,gene,1467747,1469862,1,2115,pbpH,59.76359338061465,
3158,CDS,1467747,1469862,1,2115,pbpH,59.76359338061465,penicillin-binding enzyme for formation of rod-shaped peptidoglycan cell wall
3159,gene,1470025,1471846,1,1821,kinA,59.472817133443165,
3160,CDS,1470025,1471846,1,1821,kinA,59.472817133443165,
3161,gene,1471856,1473038,-1,1182,dapX,56.683587140439926,
3162,CDS,1471856,1473038,-1,1182,dapX,56.683587140439926,
3163,gene,1473239,1473401,-1,162,ykzT,64.81481481481481,
3164,CDS,1473239,1473401,-1,162,ykzT,64.81481481481481,
3165,gene,1473604,1474516,1,912,cheV,61.074561403508774,
3166,CDS,1473604,1474516,1,912,cheV,61.074561403508774,
3167,gene,1474559,1475024,-1,465,kre,59.13978494623656,
3168,CDS,1474559,1475024,-1,465,kre,59.13978494623656,
3169,gene,1475149,1476442,-1,1293,ykuC,57.46326372776489,
3170,CDS,1475149,1476442,-1,1293,ykuC,57.46326372776489,
3171,gene,1476517,1477012,-1,495,ltdD,49.898989898989896,
3172,CDS,1476517,1477012,-1,495,ltdD,49.898989898989896,
3173,gene,1477068,1477929,-1,861,ppeE,54.70383275261324,
3174,CDS,1477068,1477929,-1,861,ppeE,54.70383275261324,
3175,gene,1478071,1478836,1,765,fadH,49.15032679738562,
3176,CDS,1478071,1478836,1,765,fadH,49.15032679738562,
3177,gene,1479136,1480867,1,1731,ykuG,64.41363373772387,
3178,CDS,1479136,1480867,1,1731,ykuG,64.41363373772387,putative cell wall-binding protein
3179,gene,1480932,1481451,1,519,ykzU,68.20809248554913,
3180,CDS,1480932,1481451,1,519,ykzU,68.20809248554913,
3181,gene,1481546,1482095,1,549,ykuH,69.39890710382514,
3182,CDS,1481546,1482095,1,549,ykuH,69.39890710382514,
3183,gene,1482247,1483471,1,1224,ykuI,58.333333333333336,
3184,CDS,1482247,1483471,1,1224,ykuI,58.333333333333336,
3185,gene,1483556,1483640,1,84,fsrA,52.38095238095239,
3186,misc_RNA,1483556,1483640,1,84,fsrA,52.38095238095239,
3187,gene,1484116,1484356,1,240,ykuJ,61.66666666666667,
3188,CDS,1484116,1484356,1,240,ykuJ,61.66666666666667,
3189,gene,1484465,1484984,1,519,ykuK,56.26204238921002,
3190,CDS,1484465,1484984,1,519,ykuK,56.26204238921002,
3191,gene,1485117,1485315,1,198,abbA,61.111111111111114,
3192,CDS,1485117,1485315,1,198,abbA,61.111111111111114,
3193,gene,1485452,1485896,1,444,ykuL,59.45945945945946,
3194,CDS,1485452,1485896,1,444,ykuL,59.45945945945946,
3195,gene,1486044,1486926,1,882,ccpC,58.049886621315196,
3196,CDS,1486044,1486926,1,882,ccpC,58.049886621315196,
3197,gene,1487037,1487514,1,477,fldN,58.280922431865825,
3198,CDS,1487037,1487514,1,477,fldN,58.280922431865825,
3199,gene,1487503,1488397,1,894,ykuO,56.152125279642064,
3200,CDS,1487503,1488397,1,894,ykuO,56.152125279642064,
3201,gene,1488412,1488868,1,456,fldP,55.92105263157895,
3202,CDS,1488412,1488868,1,456,fldP,55.92105263157895,
3203,gene,1488972,1489683,1,711,dapH,55.69620253164557,
3204,CDS,1488972,1489683,1,711,dapH,55.69620253164557,
3205,gene,1489752,1490877,1,1125,dapI,55.111111111111114,
3206,CDS,1489752,1490877,1,1125,dapI,55.111111111111114,
3207,gene,1490938,1491184,1,246,ykuS,58.94308943089431,
3208,CDS,1490938,1491184,1,246,ykuS,58.94308943089431,
3209,gene,1491220,1492024,-1,804,mscT,58.2089552238806,
3210,CDS,1491220,1492024,-1,804,mscT,58.2089552238806,
3211,gene,1492260,1492803,1,543,ahpA,55.98526703499079,
3212,CDS,1492260,1492803,1,543,ahpA,55.98526703499079,
3213,gene,1492874,1493321,1,447,ykuV,55.92841163310962,
3214,CDS,1492874,1493321,1,447,ykuV,55.92841163310962,
3215,gene,1493786,1494362,1,576,rok,57.638888888888886,
3216,CDS,1493786,1494362,1,576,rok,57.638888888888886,
3217,gene,1494402,1495368,-1,966,sppO,61.28364389233955,
3218,CDS,1494402,1495368,-1,966,sppO,61.28364389233955,
3219,gene,1495504,1496104,1,600,mobA,55.166666666666664,
3220,CDS,1495504,1496104,1,600,mobA,55.166666666666664,
3221,gene,1496154,1497174,1,1020,moeB,52.156862745098046,
3222,CDS,1496154,1497174,1,1020,moeB,52.156862745098046,
3223,gene,1497191,1498484,1,1293,moeA,50.42536736272235,
3224,CDS,1497191,1498484,1,1293,moeA,50.42536736272235,
3225,gene,1498444,1498966,1,522,mobB,52.29885057471264,
3226,CDS,1498444,1498966,1,522,mobB,52.29885057471264,
3227,gene,1498965,1499439,1,474,moaE,53.79746835443038,
3228,CDS,1498965,1499439,1,474,moaE,53.79746835443038,
3229,gene,1499431,1499665,1,234,moaD,58.54700854700855,
3230,CDS,1499431,1499665,1,234,moaD,58.54700854700855,
3231,gene,1499888,1501646,1,1758,yknU,56.42775881683731,
3232,CDS,1499888,1501646,1,1758,yknU,56.42775881683731,
3233,gene,1501657,1503472,1,1815,yknV,54.710743801652896,
3234,CDS,1501657,1503472,1,1815,yknV,54.710743801652896,
3235,gene,1503581,1504277,1,696,skiW,57.04022988505747,
3236,CDS,1503581,1504277,1,696,skiW,57.04022988505747,
3237,gene,1504281,1505415,1,1134,skiX,57.67195767195767,
3238,CDS,1504281,1505415,1,1134,skiX,57.67195767195767,
3239,gene,1505415,1506108,1,693,skiY,51.515151515151516,
3240,CDS,1505415,1506108,1,693,skiY,51.515151515151516,
3241,gene,1506104,1507298,1,1194,skiZ,54.187604690117254,
3242,CDS,1506104,1507298,1,1194,skiZ,54.187604690117254,
3243,gene,1507577,1508333,1,756,fruR,58.46560846560847,
3244,CDS,1507577,1508333,1,756,fruR,58.46560846560847,
3245,gene,1508329,1509241,1,912,fruK,55.48245614035088,
3246,CDS,1508329,1509241,1,912,fruK,55.48245614035088,
3247,gene,1509255,1511163,1,1908,fruA,53.40670859538784,
3248,CDS,1509255,1511163,1,1908,fruA,53.40670859538784,
3249,gene,1511307,1511889,1,582,sipT,58.075601374570454,
3250,CDS,1511307,1511889,1,582,sipT,58.075601374570454,
3251,gene,1511922,1512192,-1,270,ykoA,62.22222222222222,
3252,CDS,1511922,1512192,-1,270,ykoA,62.22222222222222,
3253,gene,1512372,1513995,1,1623,ykpA,56.06900800985829,
3254,CDS,1512372,1513995,1,1623,ykpA,56.06900800985829,
3255,gene,1514051,1514963,1,912,panE,54.71491228070175,
3256,CDS,1514051,1514963,1,912,panE,54.71491228070175,
3257,gene,1514996,1516229,-1,1233,ampS,57.09651257096513,
3258,CDS,1514996,1516229,-1,1233,ampS,57.09651257096513,
3259,gene,1516338,1516473,-1,135,ykpC,56.2962962962963,
3260,CDS,1516338,1516473,-1,135,ykpC,56.2962962962963,
3261,gene,1516573,1517581,-1,1008,mreBH,53.37301587301587,
3262,CDS,1516573,1517581,-1,1008,mreBH,53.37301587301587,
3263,gene,1517864,1518143,1,279,abhA,61.648745519713266,
3264,CDS,1517864,1518143,1,279,abhA,61.648745519713266,
3265,gene,1518332,1519619,1,1287,kinC,60.37296037296037,
3266,CDS,1518332,1519619,1,1287,kinC,60.37296037296037,
3267,gene,1519634,1520468,1,834,ykqA,57.31414868105516,
3268,CDS,1519634,1520468,1,834,ykqA,57.31414868105516,
3269,gene,1520530,1521196,1,666,ktrC,57.80780780780781,
3270,CDS,1520530,1521196,1,666,ktrC,57.80780780780781,
3271,gene,1521350,1523084,1,1734,adeC,56.68973471741637,
3272,CDS,1521350,1523084,1,1734,adeC,56.68973471741637,
3273,gene,1523117,1524785,-1,1668,rnjA,55.99520383693045,
3274,CDS,1523117,1524785,-1,1668,rnjA,55.99520383693045,
3275,gene,1524790,1525000,-1,210,rnpZA,66.19047619047619,
3276,CDS,1524790,1525000,-1,210,rnpZA,66.19047619047619,
3277,gene,1525385,1526159,1,774,ykrA,57.235142118863045,
3278,CDS,1525385,1526159,1,774,ykrA,57.235142118863045,
3279,gene,1526194,1526749,-1,555,defB,56.3963963963964,
3280,CDS,1526194,1526749,-1,555,defB,56.3963963963964,
3281,gene,1526858,1527017,-1,159,ykzV,52.20125786163522,
3282,CDS,1526858,1527017,-1,159,ykzV,52.20125786163522,
3283,gene,1526923,1527067,-1,144,BSU_14568,52.083333333333336,
3284,CDS,1526923,1527067,-1,144,BSU_14568,52.083333333333336,
3285,gene,1527230,1527902,1,672,ykyA,62.351190476190474,
3286,CDS,1527230,1527902,1,672,ykyA,62.351190476190474,
3287,gene,1528325,1529441,1,1116,pdhA,56.63082437275986,
3288,CDS,1528325,1529441,1,1116,pdhA,56.63082437275986,
3289,gene,1529444,1530422,1,978,pdhB,55.010224948875255,
3290,CDS,1529444,1530422,1,978,pdhB,55.010224948875255,
3291,gene,1530536,1531865,1,1329,pdhC,55.68096313017307,
3292,CDS,1530536,1531865,1,1329,pdhC,55.68096313017307,
3293,gene,1531869,1533282,1,1413,pdhD,55.48478414720452,
3294,CDS,1531869,1533282,1,1413,pdhD,55.48478414720452,
3295,gene,1533326,1533701,-1,375,slp,60.266666666666666,
3296,CDS,1533326,1533701,-1,375,slp,60.266666666666666,
3297,gene,1534069,1534280,1,211,srrA,64.45497630331754,
3298,misc_RNA,1534069,1534280,1,211,srrA,64.45497630331754,
3299,gene,1534119,1534239,1,120,rgpA,60.83333333333333,
3300,CDS,1534119,1534239,1,120,rgpA,60.83333333333333,
3301,gene,1534278,1535751,-1,1473,speA,56.551255940257974,
3302,CDS,1534278,1535751,-1,1473,speA,56.551255940257974,
3303,gene,1535935,1536202,1,267,yktA,55.80524344569289,
3304,CDS,1535935,1536202,1,267,yktA,55.80524344569289,
3305,gene,1536234,1536873,-1,639,yktB,56.18153364632238,
3306,CDS,1536234,1536873,-1,639,yktB,56.18153364632238,
3307,gene,1537112,1537301,1,189,ykzI,62.43386243386243,
3308,CDS,1537112,1537301,1,189,ykzI,62.43386243386243,
3309,gene,1537440,1538238,1,798,suhB,57.01754385964912,
3310,CDS,1537440,1538238,1,798,suhB,57.01754385964912,
3311,gene,1538263,1538692,1,429,ykzC,54.312354312354316,
3312,CDS,1538263,1538692,1,429,ykzC,54.312354312354316,
3313,gene,1538769,1539684,-1,915,yktD,61.53005464480874,
3314,CDS,1538769,1539684,-1,915,yktD,61.53005464480874,
3315,gene,1540035,1541601,-1,1566,nprE,55.172413793103445,
3316,CDS,1540035,1541601,-1,1566,nprE,55.172413793103445,
3317,gene,1541885,1543826,1,1941,ylaA,59.35085007727975,
3318,CDS,1541885,1543826,1,1941,ylaA,59.35085007727975,
3319,gene,1543815,1544085,1,270,ylaB,65.55555555555556,
3320,CDS,1543815,1544085,1,270,ylaB,65.55555555555556,
3321,gene,1544084,1544606,1,522,sigP,59.00383141762452,
3322,CDS,1544084,1544606,1,522,sigP,59.00383141762452,
3323,gene,1544602,1544896,1,294,sigQ,55.44217687074829,
3324,CDS,1544602,1544896,1,294,sigQ,55.44217687074829,
3325,gene,1544935,1545547,-1,612,ylaE,59.150326797385624,
3326,CDS,1544935,1545547,-1,612,ylaE,59.150326797385624,
3327,gene,1545819,1546008,-1,189,ylaF,59.25925925925925,
3328,CDS,1545819,1546008,-1,189,ylaF,59.25925925925925,
3329,gene,1546120,1547959,1,1839,bipA,54.758020663404025,
3330,CDS,1546120,1547959,1,1839,bipA,54.758020663404025,
3331,gene,1548015,1548333,1,318,ylaH,54.71698113207547,
3332,CDS,1548015,1548333,1,318,ylaH,54.71698113207547,
3333,gene,1548388,1548598,-1,210,ylaI,59.523809523809526,
3334,CDS,1548388,1548598,-1,210,ylaI,59.523809523809526,
3335,gene,1548680,1549310,-1,630,ylaJ,56.19047619047619,
3336,CDS,1548680,1549310,-1,630,ylaJ,56.19047619047619,
3337,gene,1549464,1550793,1,1329,ylaK,55.68096313017307,
3338,CDS,1549464,1550793,1,1329,ylaK,55.68096313017307,
3339,gene,1550796,1551282,-1,486,ylaL,54.11522633744856,
3340,CDS,1550796,1551282,-1,486,ylaL,54.11522633744856,
3341,gene,1551384,1552314,1,930,glsB,56.666666666666664,
3342,CDS,1551384,1552314,1,930,glsB,56.666666666666664,
3343,gene,1552411,1552693,1,282,ylaN,58.86524822695035,
3344,CDS,1552411,1552693,1,282,ylaN,58.86524822695035,
3345,gene,1552898,1554110,1,1212,ftsW,57.17821782178218,
3346,CDS,1552898,1554110,1,1212,ftsW,57.17821782178218,cell-division protein; transporter of lipid-linked cell wall precursors
3347,gene,1554184,1557631,1,3447,pycA,54.801276472294745,
3348,CDS,1554184,1557631,1,3447,pycA,54.801276472294745,
3349,gene,1558033,1558954,-1,921,ctaA,57.32899022801303,
3350,CDS,1558033,1558954,-1,921,ctaA,57.32899022801303,
3351,gene,1559308,1560226,1,918,ctaB,56.5359477124183,
3352,CDS,1559308,1560226,1,918,ctaB,56.5359477124183,
3353,gene,1560465,1561536,1,1071,ctaC,56.76937441643324,
3354,CDS,1560465,1561536,1,1071,ctaC,56.76937441643324,
3355,gene,1561568,1563437,1,1869,ctaD,52.43445692883895,
3356,CDS,1561568,1563437,1,1869,ctaD,52.43445692883895,
3357,gene,1563436,1564060,1,624,ctaE,54.48717948717948,
3358,CDS,1563436,1564060,1,624,ctaE,54.48717948717948,
3359,gene,1564062,1564395,1,333,ctaF,58.55855855855856,
3360,CDS,1564062,1564395,1,333,ctaF,58.55855855855856,
3361,gene,1564421,1565315,1,894,ctaG,54.138702460850105,
3362,CDS,1564421,1565315,1,894,ctaG,54.138702460850105,
3363,gene,1565346,1565709,-1,363,ylbA,53.71900826446281,
3364,CDS,1565346,1565709,-1,363,ylbA,53.71900826446281,
3365,gene,1565848,1566295,1,447,ylbB,57.27069351230425,
3366,CDS,1565848,1566295,1,447,ylbB,57.27069351230425,
3367,gene,1566378,1567419,1,1041,ylbC,57.73294908741594,
3368,CDS,1566378,1567419,1,1041,ylbC,57.73294908741594,
3369,gene,1567650,1568049,1,399,ylbD,57.14285714285714,
3370,CDS,1567650,1568049,1,399,ylbD,57.14285714285714,
3371,gene,1568064,1568304,1,240,ylbE,59.166666666666664,
3372,CDS,1568064,1568304,1,240,ylbE,59.166666666666664,
3373,gene,1568419,1568869,1,450,ricF,51.77777777777778,
3374,CDS,1568419,1568869,1,450,ricF,51.77777777777778,
3375,gene,1568923,1569196,1,273,ylbG,62.27106227106227,
3376,CDS,1568923,1569196,1,273,ylbG,62.27106227106227,
3377,gene,1569198,1569319,1,121,csfG,52.066115702479344,
3378,misc_RNA,1569198,1569319,1,121,csfG,52.066115702479344,
3379,gene,1569518,1570073,1,555,rsmD,55.31531531531532,
3380,CDS,1569518,1570073,1,555,rsmD,55.31531531531532,
3381,gene,1570077,1570563,1,486,coaD,58.0246913580247,
3382,CDS,1570077,1570563,1,486,coaD,58.0246913580247,
3383,gene,1570573,1571800,-1,1227,spoVV,54.930725346373265,
3384,CDS,1570573,1571800,-1,1227,spoVV,54.930725346373265,
3385,gene,1571980,1572763,1,783,ylbK,53.12899106002554,
3386,CDS,1571980,1572763,1,783,ylbK,53.12899106002554,
3387,gene,1572764,1573790,1,1026,ylbL,58.28460038986355,
3388,CDS,1572764,1573790,1,1026,ylbL,58.28460038986355,
3389,gene,1573806,1575054,-1,1248,ylbM,55.368589743589745,
3390,CDS,1573806,1575054,-1,1248,ylbM,55.368589743589745,
3391,gene,1575050,1575236,-1,186,ylzH,69.35483870967742,
3392,CDS,1575050,1575236,-1,186,ylzH,69.35483870967742,
3393,gene,1575263,1575782,1,519,ylbN,61.657032755298644,
3394,CDS,1575263,1575782,1,519,ylbN,61.657032755298644,
3395,gene,1575803,1575983,1,180,rpmF,61.111111111111114,
3396,CDS,1575803,1575983,1,180,rpmF,61.111111111111114,
3397,gene,1576128,1576710,1,582,gerR,54.81099656357389,
3398,CDS,1576128,1576710,1,582,gerR,54.81099656357389,
3400,CDS,1576766,1577249,-1,483,ylbP,57.7639751552795,
3399,gene,1576766,1577249,-1,483,ylbP,57.7639751552795,
3401,gene,1577408,1578305,1,897,panE,54.06911928651059,
3402,CDS,1577408,1578305,1,897,panE,54.06911928651059,
3403,gene,1578375,1579995,1,1620,bshC,57.28395061728395,
3404,CDS,1578375,1579995,1,1620,bshC,57.28395061728395,
3405,gene,1580120,1580552,1,432,mraZ,58.79629629629629,
3406,CDS,1580120,1580552,1,432,mraZ,58.79629629629629,
3407,gene,1580621,1581557,1,936,rsmH,54.27350427350427,
3408,CDS,1580621,1581557,1,936,rsmH,54.27350427350427,
3409,gene,1581596,1581950,1,354,ftsL,57.909604519774014,
3410,CDS,1581596,1581950,1,354,ftsL,57.909604519774014,
3411,gene,1581946,1584097,1,2151,pbpB,57.88005578800558,
3412,CDS,1581946,1584097,1,2151,pbpB,57.88005578800558,
3413,gene,1584213,1586154,1,1941,spoVD,54.14734672849046,
3414,CDS,1584213,1586154,1,1941,spoVD,54.14734672849046,
3415,gene,1586329,1587814,1,1485,murE,53.87205387205387,
3416,CDS,1586329,1587814,1,1485,murE,53.87205387205387,
3418,CDS,1587925,1588900,1,975,mraY,57.230769230769226,
3417,gene,1587925,1588900,1,975,mraY,57.230769230769226,
3420,CDS,1588900,1590256,1,1356,murD,54.9410029498525,
3419,gene,1588900,1590256,1,1356,murD,54.9410029498525,
3421,gene,1590316,1591417,1,1101,spoVE,53.13351498637602,
3422,CDS,1590316,1591417,1,1101,spoVE,53.13351498637602,
3423,gene,1591539,1592631,1,1092,murG,55.952380952380956,
3424,CDS,1591539,1592631,1,1092,murG,55.952380952380956,
3426,CDS,1592662,1593574,1,912,murB,53.72807017543859,
3425,gene,1592662,1593574,1,912,murB,53.72807017543859,
3428,CDS,1593703,1594495,1,792,divIB,62.62626262626263,
3427,gene,1593703,1594495,1,792,divIB,62.62626262626263,
3429,gene,1594491,1595187,1,696,ylxW,57.47126436781609,
3430,CDS,1594491,1595187,1,696,ylxW,57.47126436781609,
3431,gene,1595209,1595917,1,708,ylxX,59.32203389830508,
3432,CDS,1595209,1595917,1,708,ylxX,59.32203389830508,
3433,gene,1595934,1596300,1,366,sbp,62.841530054644814,
3434,CDS,1595934,1596300,1,366,sbp,62.841530054644814,
3435,gene,1596473,1597796,1,1323,ftsA,56.53817082388512,
3436,CDS,1596473,1597796,1,1323,ftsA,56.53817082388512,
3438,CDS,1597831,1598980,1,1149,ftsZ,52.65448215839861,
3437,gene,1597831,1598980,1,1149,ftsZ,52.65448215839861,
3439,gene,1599282,1603584,1,4302,bpr,55.299860529986056,
3440,CDS,1599282,1603584,1,4302,bpr,55.299860529986056,
3441,gene,1603778,1604708,1,930,spoIIGA,60.537634408602145,
3442,CDS,1603778,1604708,1,930,spoIIGA,60.537634408602145,
3444,CDS,1604770,1605490,1,720,sigE,59.44444444444444,
3443,gene,1604770,1605490,1,720,sigE,59.44444444444444,
3445,gene,1605629,1606412,1,783,sigG,57.21583652618135,
3446,CDS,1605629,1606412,1,783,sigG,57.21583652618135,
3448,CDS,1606559,1607354,1,795,ylmA,57.484276729559745,
3447,gene,1606559,1607354,1,795,ylmA,57.484276729559745,
3449,gene,1607366,1607468,1,102,tswE,47.05882352941176,
3450,misc_RNA,1607366,1607468,1,102,tswE,47.05882352941176,
3451,gene,1607555,1608836,1,1281,thiQ,54.56674473067916,
3452,CDS,1607555,1608836,1,1281,thiQ,54.56674473067916,
3454,CDS,1608918,1609164,1,246,ylmC,61.382113821138205,
3453,gene,1608918,1609164,1,246,ylmC,61.382113821138205,
3456,CDS,1609326,1610163,1,837,ylmD,54.24133811230586,
3455,gene,1609326,1610163,1,837,ylmD,54.24133811230586,
3457,gene,1610169,1610862,1,693,ylmE,54.689754689754686,
3458,CDS,1610169,1610862,1,693,ylmE,54.689754689754686,
3459,gene,1610858,1611314,1,456,sepF,55.26315789473685,
3460,CDS,1610858,1611314,1,456,sepF,55.26315789473685,
3461,gene,1611320,1611593,1,273,ylmG,59.70695970695971,
3462,CDS,1611320,1611593,1,273,ylmG,59.70695970695971,
3463,gene,1611653,1612427,1,774,ylmH,52.32558139534884,
3464,CDS,1611653,1612427,1,774,ylmH,52.32558139534884,
3465,gene,1612520,1613015,1,495,divIVA,62.22222222222222,
3466,CDS,1612520,1613015,1,495,divIVA,62.22222222222222,
3467,gene,1613077,1613304,1,227,iswA,52.863436123348016,
3468,misc_RNA,1613077,1613304,1,227,iswA,52.863436123348016,
3470,CDS,1613356,1616122,1,2766,ileS,55.169920462762114,
3469,gene,1613356,1616122,1,2766,ileS,55.169920462762114,
3471,gene,1616266,1616641,1,375,ylyA,59.46666666666667,
3472,CDS,1616266,1616641,1,375,ylyA,59.46666666666667,
3473,gene,1616743,1617208,1,465,lspA,58.70967741935483,
3474,CDS,1616743,1617208,1,465,lspA,58.70967741935483,
3475,gene,1617209,1618121,1,912,rluD,53.17982456140351,
3476,CDS,1617209,1618121,1,912,rluD,53.17982456140351,
3477,gene,1618160,1618277,1,117,pyaA,51.28205128205128,
3478,misc_RNA,1618160,1618277,1,117,pyaA,51.28205128205128,
3479,gene,1618303,1618849,1,546,pyrR,56.41025641025641,
3480,CDS,1618303,1618849,1,546,pyrR,56.41025641025641,
3481,gene,1618852,1618970,1,118,pyaB,59.32203389830508,
3482,misc_RNA,1618852,1618970,1,118,pyaB,59.32203389830508,
3483,gene,1619022,1620330,1,1308,pyrP,50.53516819571865,
3484,CDS,1619022,1620330,1,1308,pyrP,50.53516819571865,
3485,gene,1620330,1620445,1,115,pyaC,57.391304347826086,
3486,misc_RNA,1620330,1620445,1,115,pyaC,57.391304347826086,
3487,gene,1620475,1621390,1,915,pyrB,54.20765027322404,
3488,CDS,1620475,1621390,1,915,pyrB,54.20765027322404,
3489,gene,1621373,1622660,1,1287,pyrC,53.613053613053616,
3490,CDS,1621373,1622660,1,1287,pyrC,53.613053613053616,
3491,gene,1622656,1623751,1,1095,pyrAA,55.06849315068493,
3492,CDS,1622656,1623751,1,1095,pyrAA,55.06849315068493,
3493,gene,1623735,1626951,1,3216,pyrAB,53.513681592039795,
3494,CDS,1623735,1626951,1,3216,pyrAB,53.513681592039795,
3495,gene,1626947,1627718,1,771,pyrK,51.88067444876784,
3496,CDS,1626947,1627718,1,771,pyrK,51.88067444876784,
3497,gene,1627717,1628653,1,936,pyrD,52.13675213675214,
3498,CDS,1627717,1628653,1,936,pyrD,52.13675213675214,
3499,gene,1628621,1629341,1,720,pyrF,53.05555555555556,
3500,CDS,1628621,1629341,1,720,pyrF,53.05555555555556,
3501,gene,1629319,1629970,1,651,pyrE,54.22427035330261,
3502,CDS,1629319,1629970,1,651,pyrE,54.22427035330261,
3503,gene,1630114,1630220,1,106,mswE,54.71698113207547,
3504,misc_RNA,1630114,1630220,1,106,mswE,54.71698113207547,
3505,gene,1630381,1631083,1,702,cysH,56.55270655270655,
3506,CDS,1630381,1631083,1,702,cysH,56.55270655270655,
3507,gene,1631094,1632159,1,1065,cysP,53.42723004694836,
3508,CDS,1631094,1632159,1,1065,cysP,53.42723004694836,
3509,gene,1632207,1633356,1,1149,sat,56.48389904264578,
3510,CDS,1632207,1633356,1,1149,sat,56.48389904264578,
3511,gene,1633368,1633962,1,594,cysC,55.218855218855225,
3512,CDS,1633368,1633962,1,594,cysC,55.218855218855225,
3513,gene,1634060,1634834,1,774,sumT,57.49354005167958,
3514,CDS,1634060,1634834,1,774,sumT,57.49354005167958,
3515,gene,1634836,1635622,1,786,sirB,55.85241730279898,
3516,CDS,1634836,1635622,1,786,sirB,55.85241730279898,
3517,gene,1635602,1636091,1,489,sirC,54.601226993865026,
3518,CDS,1635602,1636091,1,489,sirC,54.601226993865026,
3519,gene,1636130,1637849,-1,1719,fbnA,56.02094240837696,
3520,CDS,1636130,1637849,-1,1719,fbnA,56.02094240837696,
3521,gene,1637964,1640637,1,2673,tcaB,52.861952861952865,
3522,CDS,1637964,1640637,1,2673,tcaB,52.861952861952865,
3523,gene,1640719,1641595,1,876,yloC,55.70776255707762,
3524,CDS,1640719,1641595,1,876,yloC,55.70776255707762,
3525,gene,1641671,1641941,1,270,remA,54.44444444444444,
3526,CDS,1641671,1641941,1,270,remA,54.44444444444444,
3527,gene,1641948,1642563,1,615,gmk,57.886178861788615,
3528,CDS,1641948,1642563,1,615,gmk,57.886178861788615,
3529,gene,1642566,1642770,1,204,rpoZ,63.23529411764706,
3530,CDS,1642566,1642770,1,204,rpoZ,63.23529411764706,
3531,gene,1642850,1644071,1,1221,coaBC,53.64455364455365,
3532,CDS,1642850,1644071,1,1221,coaBC,53.64455364455365,
3533,gene,1644067,1646485,1,2418,priA,53.59801488833747,
3534,CDS,1644067,1646485,1,2418,priA,53.59801488833747,
3535,gene,1646511,1646994,1,483,defA,55.27950310559007,
3536,CDS,1646511,1646994,1,483,defA,55.27950310559007,
3537,gene,1646998,1647952,1,954,fmt,52.41090146750524,
3538,CDS,1646998,1647952,1,954,fmt,52.41090146750524,
3539,gene,1647938,1649282,1,1344,rsmB,53.49702380952381,
3540,CDS,1647938,1649282,1,1344,rsmB,53.49702380952381,
3541,gene,1649285,1650377,1,1092,rlmN,55.494505494505496,
3542,CDS,1649285,1650377,1,1092,rlmN,55.494505494505496,
3543,gene,1650383,1651148,1,765,prpC,54.64052287581699,
3544,CDS,1650383,1651148,1,765,prpC,54.64052287581699,
3545,gene,1651141,1653088,1,1947,prkC,55.82948125321007,
3546,CDS,1651141,1653088,1,1947,prkC,55.82948125321007,
3547,gene,1653102,1653999,1,897,rsgA,56.187290969899664,
3548,CDS,1653102,1653999,1,897,rsgA,56.187290969899664,
3549,gene,1654003,1654657,1,654,rpe,53.97553516819572,
3550,CDS,1654003,1654657,1,654,rpe,53.97553516819572,
3551,gene,1654729,1655374,1,645,thiN,59.06976744186046,
3552,CDS,1654729,1655374,1,645,thiN,59.06976744186046,
3553,gene,1655445,1655526,1,81,spoVM,62.96296296296296,
3554,CDS,1655445,1655526,1,81,spoVM,62.96296296296296,
3555,gene,1655598,1655787,-1,189,rpmB,57.67195767195767,
3556,CDS,1655598,1655787,-1,189,rpmB,57.67195767195767,
3557,gene,1656063,1656426,1,363,yloU,55.64738292011019,
3558,CDS,1656063,1656426,1,363,yloU,55.64738292011019,
3559,gene,1656441,1658103,1,1662,yloV,53.79061371841155,
3560,CDS,1656441,1658103,1,1662,yloV,53.79061371841155,
3561,gene,1658241,1658904,1,663,sdaAB,54.44947209653092,
3562,CDS,1658241,1658904,1,663,sdaAB,54.44947209653092,
3563,gene,1658929,1659832,1,903,sdaAA,52.602436323366554,
3564,CDS,1658929,1659832,1,903,sdaAA,52.602436323366554,
3565,gene,1659809,1661858,1,2049,recG,54.61200585651538,
3566,CDS,1659809,1661858,1,2049,recG,54.61200585651538,
3567,gene,1661966,1662533,1,567,fapR,55.55555555555556,
3568,CDS,1661966,1662533,1,567,fapR,55.55555555555556,
3569,gene,1662546,1663548,1,1002,plsX,54.690618762475054,
3570,CDS,1662546,1663548,1,1002,plsX,54.690618762475054,
3571,gene,1663566,1664520,1,954,fabD,54.71698113207547,
3572,CDS,1663566,1664520,1,954,fabD,54.71698113207547,
3573,gene,1664512,1665253,1,741,fabG,55.87044534412956,
3574,CDS,1664512,1665253,1,741,fabG,55.87044534412956,
3575,gene,1665336,1665570,1,234,acpA,57.26495726495726,
3576,CDS,1665336,1665570,1,234,acpA,57.26495726495726,
3577,gene,1665709,1666459,1,750,rnc,58.266666666666666,
3578,CDS,1665709,1666459,1,750,rnc,58.266666666666666,
3579,gene,1666559,1670120,1,3561,smc,54.787980904240385,
3580,CDS,1666559,1670120,1,3561,smc,54.787980904240385,
3581,gene,1670139,1671129,1,990,ftsY,57.07070707070707,
3582,CDS,1670139,1671129,1,990,ftsY,57.07070707070707,
3583,gene,1671165,1671651,-1,486,ylqB,56.79012345679012,
3584,CDS,1671165,1671651,-1,486,ylqB,56.79012345679012,
3585,gene,1671827,1672160,1,333,ylxM,63.06306306306306,
3586,CDS,1671827,1672160,1,333,ylxM,63.06306306306306,
3587,gene,1672173,1673514,1,1341,ffh,52.94556301267711,
3588,CDS,1672173,1673514,1,1341,ffh,52.94556301267711,
3589,gene,1673619,1673892,1,273,rpsP,58.24175824175825,
3590,CDS,1673619,1673892,1,273,rpsP,58.24175824175825,
3591,gene,1673891,1674137,1,246,ylqC,57.72357723577236,
3592,CDS,1673891,1674137,1,246,ylqC,57.72357723577236,
3593,gene,1674258,1674645,1,387,ylqD,60.72351421188631,
3594,CDS,1674258,1674645,1,387,ylqD,60.72351421188631,
3595,gene,1674649,1675174,1,525,rimM,60.0,
3596,CDS,1674649,1675174,1,525,rimM,60.0,
3597,gene,1675170,1675902,1,732,trmD,53.00546448087432,
3598,CDS,1675170,1675902,1,732,trmD,53.00546448087432,
3599,gene,1675980,1676022,1,42,BSU_misc_RNA_30,45.23809523809524,
3600,misc_RNA,1675980,1676022,1,42,BSU_misc_RNA_30,45.23809523809524,
3601,gene,1676041,1676389,1,348,rplS,56.03448275862068,
3602,CDS,1676041,1676389,1,348,rplS,56.03448275862068,
3603,gene,1676531,1677380,1,849,rbgA,55.71260306242638,
3604,CDS,1676531,1677380,1,849,rbgA,55.71260306242638,
3605,gene,1677450,1678218,1,768,rnhB,54.6875,
3606,CDS,1677450,1678218,1,768,rnhB,54.6875,
3607,gene,1678249,1679980,1,1731,ylqG,54.07279029462738,
3608,CDS,1678249,1679980,1,1731,ylqG,54.07279029462738,
3609,gene,1679976,1680258,1,282,ylqH,58.156028368794324,
3610,CDS,1679976,1680258,1,282,ylqH,58.156028368794324,
3611,gene,1680430,1681588,1,1158,sucC,57.167530224525045,
3612,CDS,1680430,1681588,1,1158,sucC,57.167530224525045,
3613,gene,1681616,1682519,1,903,sucD,53.59911406423035,
3614,CDS,1681616,1682519,1,903,sucD,53.59911406423035,
3615,gene,1682579,1683473,1,894,dprA,55.59284116331096,
3616,CDS,1682579,1683473,1,894,dprA,55.59284116331096,
3617,gene,1683660,1685736,1,2076,topA,57.36994219653179,
3618,CDS,1683660,1685736,1,2076,topA,57.36994219653179,
3619,gene,1685811,1687119,1,1308,trmFO,56.88073394495413,
3620,CDS,1685811,1687119,1,1308,trmFO,56.88073394495413,
3621,gene,1687186,1688101,1,915,codV,60.32786885245902,
3622,CDS,1687186,1688101,1,915,codV,60.32786885245902,
3623,gene,1688113,1688659,1,546,clpQ,53.47985347985348,
3624,CDS,1688113,1688659,1,546,clpQ,53.47985347985348,
3625,gene,1688675,1690079,1,1404,clpY,57.26495726495726,
3626,CDS,1688675,1690079,1,1404,clpY,57.26495726495726,
3627,gene,1690118,1690898,1,780,codY,60.51282051282051,
3628,CDS,1690118,1690898,1,780,codY,60.51282051282051,
3629,gene,1691277,1691667,1,390,flgB,65.12820512820512,
3630,CDS,1691277,1691667,1,390,flgB,65.12820512820512,
3631,gene,1691666,1692119,1,453,flgC,57.395143487858725,
3632,CDS,1691666,1692119,1,453,flgC,57.395143487858725,
3633,gene,1692129,1692450,1,321,fliE,63.2398753894081,
3634,CDS,1692129,1692450,1,321,fliE,63.2398753894081,
3635,gene,1692495,1694106,1,1611,fliF,60.024829298572314,
3636,CDS,1692495,1694106,1,1611,fliF,60.024829298572314,
3637,gene,1694118,1695135,1,1017,fliG,58.70206489675516,
3638,CDS,1694118,1695135,1,1017,fliG,58.70206489675516,
3639,gene,1695253,1695880,1,627,fliH,58.3732057416268,
3640,CDS,1695253,1695880,1,627,fliH,58.3732057416268,
3641,gene,1695876,1697193,1,1317,fliI,54.36598329536826,
3642,CDS,1695876,1697193,1,1317,fliI,54.36598329536826,
3643,gene,1697195,1697639,1,444,fliJ,68.91891891891892,
3644,CDS,1697195,1697639,1,444,fliJ,68.91891891891892,
3645,gene,1697650,1698265,1,615,ylxF,59.34959349593496,
3646,CDS,1697650,1698265,1,615,ylxF,59.34959349593496,
3647,gene,1698277,1699741,1,1464,fliK,57.650273224043715,
3648,CDS,1698277,1699741,1,1464,fliK,57.650273224043715,
3649,gene,1699737,1700160,1,423,flgD,62.4113475177305,
3650,CDS,1699737,1700160,1,423,flgD,62.4113475177305,
3651,gene,1700181,1700976,1,795,flgE,58.11320754716981,
3652,CDS,1700181,1700976,1,795,flgE,58.11320754716981,
3653,gene,1701015,1701231,1,216,swrD,62.96296296296296,
3654,CDS,1701015,1701231,1,216,swrD,62.96296296296296,
3655,gene,1701227,1701650,1,423,fliL,65.48463356973994,
3656,CDS,1701227,1701650,1,423,fliL,65.48463356973994,
3657,gene,1701683,1702682,1,999,fliM,59.05905905905906,
3658,CDS,1701683,1702682,1,999,fliM,59.05905905905906,
3659,gene,1702671,1703808,1,1137,fliY,55.84872471416007,
3660,CDS,1702671,1703808,1,1137,fliY,55.84872471416007,
3661,gene,1703833,1704196,1,363,cheY,61.98347107438017,
3662,CDS,1703833,1704196,1,363,cheY,61.98347107438017,
3663,gene,1704210,1704870,1,660,fliZ,60.303030303030305,
3664,CDS,1704210,1704870,1,660,fliZ,60.303030303030305,
3665,gene,1704862,1705528,1,666,fliP,63.36336336336337,
3666,CDS,1704862,1705528,1,666,fliP,63.36336336336337,
3667,gene,1705542,1705812,1,270,fliQ,58.14814814814815,
3668,CDS,1705542,1705812,1,270,fliQ,58.14814814814815,
3669,gene,1705819,1706599,1,780,fliR,60.76923076923077,
3670,CDS,1705819,1706599,1,780,fliR,60.76923076923077,
3671,gene,1706598,1707681,1,1083,flhB,59.556786703601105,
3672,CDS,1706598,1707681,1,1083,flhB,59.556786703601105,
3673,gene,1707713,1709747,1,2034,flhA,56.14552605703048,
3674,CDS,1707713,1709747,1,2034,flhA,56.14552605703048,
3675,gene,1709746,1710847,1,1101,flhF,59.67302452316077,
3676,CDS,1709746,1710847,1,1101,flhF,59.67302452316077,
3677,gene,1710837,1711734,1,897,flhG,55.964325529542926,
3678,CDS,1710837,1711734,1,897,flhG,55.964325529542926,
3679,gene,1711735,1712809,1,1074,cheB,55.58659217877096,
3680,CDS,1711735,1712809,1,1074,cheB,55.58659217877096,
3681,gene,1712814,1714833,1,2019,cheA,58.048538880633984,
3682,CDS,1712814,1714833,1,2019,cheA,58.048538880633984,
3683,gene,1714854,1715325,1,471,cheW,59.660297239915074,
3684,CDS,1714854,1715325,1,471,cheW,59.660297239915074,
3685,gene,1715343,1715973,1,630,cheC,54.44444444444444,
3686,CDS,1715343,1715973,1,630,cheC,54.44444444444444,
3687,gene,1715969,1716470,1,501,cheD,54.690618762475054,
3688,CDS,1715969,1716470,1,501,cheD,54.690618762475054,
3689,gene,1716492,1717257,1,765,sigD,57.77777777777777,
3690,CDS,1716492,1717257,1,765,sigD,57.77777777777777,
3691,gene,1717285,1717789,1,504,swrB,59.12698412698413,
3692,CDS,1717285,1717789,1,504,swrB,59.12698412698413,
3693,gene,1717932,1718673,1,741,rpsB,59.64912280701754,
3694,CDS,1717932,1718673,1,741,rpsB,59.64912280701754,
3695,gene,1718774,1719656,1,882,tsf,58.730158730158735,
3696,CDS,1718774,1719656,1,882,tsf,58.730158730158735,
3697,gene,1719801,1720524,1,723,pyrH,55.87828492392808,
3698,CDS,1719801,1720524,1,723,pyrH,55.87828492392808,
3699,gene,1720525,1721083,1,558,frr,61.648745519713266,
3700,CDS,1720525,1721083,1,558,frr,61.648745519713266,
3701,gene,1721213,1721996,1,783,uppS,57.34355044699873,
3702,CDS,1721213,1721996,1,783,uppS,57.34355044699873,
3703,gene,1721999,1722809,1,810,cdsA,59.50617283950618,
3704,CDS,1721999,1722809,1,810,cdsA,59.50617283950618,
3705,gene,1722870,1724022,1,1152,dxr,57.291666666666664,
3706,CDS,1722870,1724022,1,1152,dxr,57.291666666666664,
3707,gene,1724028,1725297,1,1269,rasP,56.26477541371159,
3708,CDS,1724028,1725297,1,1269,rasP,56.26477541371159,
3709,gene,1725329,1727024,1,1695,proS,55.33923303834808,
3710,CDS,1725329,1727024,1,1695,proS,55.33923303834808,
3711,gene,1727132,1731446,1,4314,polC,57.27862772369031,
3712,CDS,1727132,1731446,1,4314,polC,57.27862772369031,
3713,gene,1731456,1731674,1,218,surG,63.30275229357798,
3714,misc_RNA,1731456,1731674,1,218,surG,63.30275229357798,
3715,gene,1731775,1732246,1,471,rimP,58.59872611464968,
3716,CDS,1731775,1732246,1,471,rimP,58.59872611464968,
3717,gene,1732280,1733396,1,1116,nusA,56.272401433691755,
3718,CDS,1732280,1733396,1,1116,nusA,56.272401433691755,
3719,gene,1733409,1733685,1,276,rulR,60.14492753623188,
3720,CDS,1733409,1733685,1,276,rulR,60.14492753623188,
3721,gene,1733686,1733989,1,303,rulQ,54.12541254125413,
3722,CDS,1733686,1733989,1,303,rulQ,54.12541254125413,
3723,gene,1734008,1736159,1,2151,infB,57.08972570897257,
3724,CDS,1734008,1736159,1,2151,infB,57.08972570897257,
3725,gene,1736155,1736434,1,279,ylxP,54.83870967741935,
3726,misc_feature,1736155,1736434,1,279,ylxP,54.83870967741935,
3727,gene,1736450,1736804,1,354,rbfA,56.49717514124294,
3728,CDS,1736450,1736804,1,354,rbfA,56.49717514124294,
3729,gene,1736885,1737815,1,930,truB,56.88172043010753,
3730,CDS,1736885,1737815,1,930,truB,56.88172043010753,
3731,gene,1737833,1738784,1,951,ribC,57.93901156677181,
3732,CDS,1737833,1738784,1,951,ribC,57.93901156677181,
3733,gene,1738940,1739210,1,270,rpsO,60.0,
3734,CDS,1738940,1739210,1,270,rpsO,60.0,
3735,gene,1739382,1741500,1,2118,pnpA,54.86307837582625,
3736,CDS,1739382,1741500,1,2118,pnpA,54.86307837582625,
3737,gene,1741617,1742577,1,960,ylxY,59.895833333333336,
3738,CDS,1741617,1742577,1,960,ylxY,59.895833333333336,
3739,gene,1742616,1743846,1,1230,mlpA,56.99186991869919,
3740,CDS,1742616,1743846,1,1230,mlpA,56.99186991869919,
3741,gene,1743923,1744181,1,258,ymxH,55.81395348837209,
3742,CDS,1743923,1744181,1,258,ymxH,55.81395348837209,
3743,gene,1744366,1745260,1,894,spoVFA,55.369127516778526,
3744,CDS,1744366,1745260,1,894,spoVFA,55.369127516778526,
3745,gene,1745262,1745865,1,603,spoVFB,55.05804311774462,
3746,CDS,1745262,1745865,1,603,spoVFB,55.05804311774462,
3747,gene,1745990,1747031,1,1041,asd,55.81171950048031,
3748,CDS,1745990,1747031,1,1041,asd,55.81171950048031,
3749,gene,1747122,1748337,1,1215,dapG,52.09876543209877,
3750,CDS,1747122,1748337,1,1215,dapG,52.09876543209877,
3751,gene,1748367,1749240,1,873,dapA,55.44100801832761,
3752,CDS,1748367,1749240,1,873,dapA,55.44100801832761,
3753,gene,1749417,1751085,1,1668,rnjB,57.25419664268585,
3754,CDS,1749417,1751085,1,1668,rnjB,57.25419664268585,
3755,gene,1751200,1751938,1,738,tepA,56.639566395663955,
3756,CDS,1751200,1751938,1,738,tepA,56.639566395663955,
3757,gene,1751934,1752147,1,213,tepJ,59.624413145539904,
3758,CDS,1751934,1752147,1,213,tepJ,59.624413145539904,
3759,gene,1752277,1754641,1,2364,spoIIIE,54.99153976311336,
3760,CDS,1752277,1754641,1,2364,spoIIIE,54.99153976311336,
3761,gene,1754784,1755510,1,726,ymfC,59.917355371900825,
3762,CDS,1754784,1755510,1,726,ymfC,59.917355371900825,
3763,gene,1755648,1756857,1,1209,bcbE,58.7262200165426,
3764,CDS,1755648,1756857,1,1209,bcbE,58.7262200165426,
3765,gene,1757036,1758317,1,1281,ymfF,57.767369242779075,
3766,CDS,1757036,1758317,1,1281,ymfF,57.767369242779075,
3767,gene,1758313,1759600,1,1287,ymfH,57.73115773115774,
3768,CDS,1758313,1759600,1,1287,ymfH,57.73115773115774,
3769,gene,1759654,1760383,1,729,efpI,50.89163237311386,
3770,CDS,1759654,1760383,1,729,efpI,50.89163237311386,
3771,gene,1760463,1760721,1,258,ymfJ,56.97674418604651,
3772,CDS,1760463,1760721,1,258,ymfJ,56.97674418604651,
3773,gene,1760850,1761303,1,453,ymfKn,54.966887417218544,
3774,misc_feature,1760850,1761303,1,453,ymfKn,54.966887417218544,
3775,gene,1761301,1761640,1,339,ymfKc,57.227138643067846,
3776,misc_feature,1761301,1761640,1,339,ymfKc,57.227138643067846,
3777,gene,1761706,1762573,1,867,rodZ,60.09227220299884,
3778,CDS,1761706,1762573,1,867,rodZ,60.09227220299884,
3779,gene,1762622,1763204,1,582,pgsA,55.84192439862543,
3780,CDS,1762622,1763204,1,582,pgsA,55.84192439862543,
3781,gene,1763221,1764472,1,1251,cinA,54.036770583533176,
3782,CDS,1763221,1764472,1,1251,cinA,54.036770583533176,
3783,gene,1764644,1765691,1,1047,recA,53.29512893982808,
3784,CDS,1764644,1765691,1,1047,recA,53.29512893982808,
3785,gene,1765858,1767034,1,1176,pbpX,60.45918367346938,
3786,CDS,1765858,1767034,1,1176,pbpX,60.45918367346938,
3787,gene,1767309,1768872,1,1563,rny,53.93474088291747,
3788,CDS,1767309,1768872,1,1563,rny,53.93474088291747,
3789,gene,1768940,1769735,1,795,pdeB,55.9748427672956,
3790,CDS,1768940,1769735,1,795,pdeB,55.9748427672956,
3791,gene,1769934,1770195,1,261,spoVS,51.724137931034484,
3792,CDS,1769934,1770195,1,261,spoVS,51.724137931034484,
3793,gene,1770460,1771504,1,1044,tdh,54.11877394636016,
3794,CDS,1770460,1771504,1,1044,tdh,54.11877394636016,
3795,gene,1771516,1772695,1,1179,kbl,54.36810856658185,
3796,CDS,1771516,1772695,1,1179,kbl,54.36810856658185,
3797,gene,1772842,1774372,1,1530,miaB,56.928104575163395,
3798,CDS,1772842,1774372,1,1530,miaB,56.928104575163395,
3799,gene,1774373,1774805,1,432,ricA,57.638888888888886,
3800,CDS,1774373,1774805,1,432,ricA,57.638888888888886,
3801,gene,1775066,1775612,1,546,cotE,58.24175824175825,
3802,CDS,1775066,1775612,1,546,cotE,58.24175824175825,
3803,gene,1775744,1778321,1,2577,mutS,54.83119906868452,
3804,CDS,1775744,1778321,1,2577,mutS,54.83119906868452,
3805,gene,1778336,1780220,1,1884,mutL,52.07006369426752,
3806,CDS,1778336,1780220,1,1884,mutL,52.07006369426752,
3807,gene,1780403,1780554,-1,151,surX,62.251655629139066,
3808,misc_RNA,1780403,1780554,-1,151,surX,62.251655629139066,
3809,gene,1780617,1781073,-1,456,ymzD,64.25438596491229,
3810,CDS,1780617,1781073,-1,456,ymzD,64.25438596491229,
3811,gene,1781227,1781785,-1,558,ymcC,55.7347670250896,
3812,CDS,1781227,1781785,-1,558,ymcC,55.7347670250896,
3813,gene,1781905,1782523,1,618,pksA,56.957928802588995,
3814,CDS,1781905,1782523,1,618,pksA,56.957928802588995,
3815,gene,1782712,1783390,1,678,pksB,61.06194690265486,
3816,CDS,1782712,1783390,1,678,pksB,61.06194690265486,
3817,gene,1783499,1783766,1,267,BSU_17099,64.41947565543072,
3818,CDS,1783499,1783766,1,267,BSU_17099,64.41947565543072,
3819,gene,1783762,1784629,1,867,pksC,59.515570934256054,
3820,CDS,1783762,1784629,1,867,pksC,59.515570934256054,
3821,gene,1785132,1786107,1,975,pksD,58.05128205128205,
3822,CDS,1785132,1786107,1,975,pksD,58.05128205128205,
3823,gene,1786103,1788407,1,2304,pksE,57.161458333333336,
3824,CDS,1786103,1788407,1,2304,pksE,57.161458333333336,
3825,gene,1788468,1788717,1,249,acpK,58.23293172690763,
3826,CDS,1788468,1788717,1,249,acpK,58.23293172690763,
3827,gene,1788694,1789942,1,1248,pksF,53.28525641025641,
3828,CDS,1788694,1789942,1,1248,pksF,53.28525641025641,
3829,gene,1789942,1791205,1,1263,pksG,52.96912114014252,
3830,CDS,1789942,1791205,1,1263,pksG,52.96912114014252,
3831,gene,1791192,1791972,1,780,pksH,54.871794871794876,
3832,CDS,1791192,1791972,1,780,pksH,54.871794871794876,
3833,gene,1792011,1792761,1,750,pksI,56.13333333333333,
3834,CDS,1792011,1792761,1,750,pksI,56.13333333333333,
3835,gene,1792805,1807937,1,15132,pksJ,53.476077187417395,
3836,CDS,1792805,1807937,1,15132,pksJ,53.476077187417395,
3837,gene,1807920,1821537,1,13617,pksL,53.102739223030035,
3838,CDS,1807920,1821537,1,13617,pksL,53.102739223030035,
3839,gene,1821552,1834341,1,12789,pksM,54.02298850574713,
3840,CDS,1821552,1834341,1,12789,pksM,54.02298850574713,
3841,gene,1834408,1850875,1,16467,pksN,53.86530637031639,
3842,CDS,1834408,1850875,1,16467,pksN,53.86530637031639,
3843,gene,1850889,1858521,1,7632,pksR,55.634171907756816,
3844,CDS,1850889,1858521,1,7632,pksR,55.634171907756816,
3845,gene,1858565,1859783,-1,1218,pksS,58.94909688013136,
3846,CDS,1858565,1859783,-1,1218,pksS,58.94909688013136,
3847,gene,1860013,1860370,-1,357,ymzB,57.98319327731093,
3848,CDS,1860013,1860370,-1,357,ymzB,57.98319327731093,
3849,gene,1860448,1861273,-1,825,ymaE,54.54545454545454,
3850,CDS,1860448,1861273,-1,825,ymaE,54.54545454545454,
3851,gene,1861383,1862712,-1,1329,aprX,52.595936794582386,
3852,CDS,1861383,1862712,-1,1329,aprX,52.595936794582386,
3853,gene,1862936,1862993,1,57,ymzEn,64.91228070175438,
3854,misc_feature,1862936,1862993,1,57,ymzEn,64.91228070175438,
3855,gene,1862991,1863168,1,177,ymzEc,65.5367231638418,
3856,misc_feature,1862991,1863168,1,177,ymzEc,65.5367231638418,
3857,gene,1863447,1864155,1,708,pghC,60.31073446327684,
3858,CDS,1863447,1864155,1,708,pghC,60.31073446327684,
3859,gene,1864224,1864677,1,453,ymaD,53.86313465783664,
3860,CDS,1864224,1864677,1,453,ymaD,53.86313465783664,
3861,gene,1864690,1865044,-1,354,ebrB,55.08474576271186,
3862,CDS,1864690,1865044,-1,354,ebrB,55.08474576271186,
3863,gene,1865057,1865375,-1,318,ebrA,54.40251572327044,
3864,CDS,1865057,1865375,-1,318,ebrA,54.40251572327044,
3865,gene,1865511,1865787,-1,276,ymaG,52.53623188405797,
3866,CDS,1865511,1865787,-1,276,ymaG,52.53623188405797,inner spore coat protein; cell wall associated protein
3867,gene,1865875,1866289,1,414,ymaF,52.17391304347826,
3868,CDS,1865875,1866289,1,414,ymaF,52.17391304347826,
3869,gene,1866388,1867333,1,945,miaA,56.19047619047619,
3870,CDS,1866388,1867333,1,945,miaA,56.19047619047619,
3871,gene,1867372,1867594,1,222,hfq,59.45945945945946,
3872,CDS,1867372,1867594,1,222,hfq,59.45945945945946,
3873,gene,1867789,1868062,1,273,ymzC,57.87545787545788,
3874,CDS,1867789,1868062,1,273,ymzC,57.87545787545788,
3875,gene,1868143,1868374,1,231,ymzA,63.63636363636363,
3876,CDS,1868143,1868374,1,231,ymzA,63.63636363636363,
3877,gene,1868616,1869009,1,393,nrdI,56.234096692111954,
3878,CDS,1868616,1869009,1,393,nrdI,56.234096692111954,
3879,gene,1868968,1871071,1,2103,nrdE,58.01236329053733,
3880,CDS,1868968,1871071,1,2103,nrdE,58.01236329053733,
3881,gene,1871088,1872078,1,990,nrdF,58.58585858585859,
3882,CDS,1871088,1872078,1,990,nrdF,58.58585858585859,
3883,gene,1872127,1872748,1,621,ymaB,56.038647342995176,
3884,CDS,1872127,1872748,1,621,ymaB,56.038647342995176,
3885,gene,1872811,1873579,-1,768,cwlC,53.90625,
3886,CDS,1872811,1873579,-1,768,cwlC,53.90625,
3887,gene,1874202,1875171,1,969,spoVK,55.83075335397317,
3888,CDS,1874202,1875171,1,969,spoVK,55.83075335397317,
3889,gene,1875303,1876566,1,1263,hflX,54.07759303246239,
3890,CDS,1875303,1876566,1,1263,hflX,54.07759303246239,
3891,gene,1876583,1877849,1,1266,ynbB,54.02843601895735,
3892,CDS,1876583,1877849,1,1266,ynbB,54.02843601895735,
3893,gene,1877958,1878366,1,408,glnR,59.80392156862745,
3894,CDS,1877958,1878366,1,408,glnR,59.80392156862745,
3895,gene,1878424,1879759,1,1335,glnA,55.955056179775276,
3896,CDS,1878424,1879759,1,1335,glnA,55.955056179775276,
3897,gene,1880086,1880377,1,291,ynxB,65.63573883161511,
3898,CDS,1880086,1880377,1,291,ynxB,65.63573883161511,
3899,gene,1880622,1880967,1,345,ynzF,62.60869565217392,
3900,CDS,1880622,1880967,1,345,ynzF,62.60869565217392,
3901,gene,1881097,1881349,1,252,ynzG,66.66666666666666,
3902,CDS,1881097,1881349,1,252,ynzG,66.66666666666666,
3903,gene,1881535,1881970,1,435,ynaB,67.1264367816092,
3904,CDS,1881535,1881970,1,435,ynaB,67.1264367816092,
3905,gene,1882039,1882831,1,792,ynaC,68.3080808080808,
3906,CDS,1882039,1882831,1,792,ynaC,68.3080808080808,
3907,gene,1883165,1883678,1,513,ynaD,66.66666666666666,
3908,CDS,1883165,1883678,1,513,ynaD,66.66666666666666,
3909,gene,1884237,1884879,1,642,ynaE,67.601246105919,
3910,CDS,1884237,1884879,1,642,ynaE,67.601246105919,
3911,gene,1884967,1885321,1,354,ynaF,69.49152542372882,
3912,CDS,1884967,1885321,1,354,ynaF,69.49152542372882,
3913,gene,1885364,1885640,1,276,ynaG,67.7536231884058,
3914,CDS,1885364,1885640,1,276,ynaG,67.7536231884058,
3915,gene,1885752,1885917,1,165,ynzI,67.87878787878789,
3916,CDS,1885752,1885917,1,165,ynzI,67.87878787878789,
3917,gene,1886056,1886527,1,471,ynaI,71.76220806794055,
3918,CDS,1886056,1886527,1,471,ynaI,71.76220806794055,
3919,gene,1887351,1888743,1,1392,xynP,62.5,
3920,CDS,1887351,1888743,1,1392,xynP,62.5,
3921,gene,1888773,1890375,1,1602,xynB,62.60923845193508,
3922,CDS,1888773,1890375,1,1602,xynB,62.60923845193508,
3923,gene,1890511,1891666,-1,1155,xylR,64.58874458874459,
3924,CDS,1890511,1891666,-1,1155,xylR,64.58874458874459,
3925,gene,1891907,1893245,1,1338,xylA,59.64125560538116,
3926,CDS,1891907,1893245,1,1338,xylA,59.64125560538116,
3927,gene,1893395,1894895,1,1500,xylB,58.599999999999994,
3928,CDS,1893395,1894895,1,1500,xylB,58.599999999999994,
3929,gene,1895377,1896013,-1,636,yncB,61.0062893081761,
3930,CDS,1895377,1896013,-1,636,yncB,61.0062893081761,
3931,gene,1896423,1897839,1,1416,yncC,58.47457627118644,
3932,CDS,1896423,1897839,1,1416,yncC,58.47457627118644,
3933,gene,1897940,1899125,-1,1185,alrB,56.118143459915615,
3934,CDS,1897940,1899125,-1,1185,alrB,56.118143459915615,
3935,gene,1899588,1900050,1,462,yncE,65.5844155844156,
3936,CDS,1899588,1900050,1,462,yncE,65.5844155844156,
3937,gene,1900079,1900514,1,435,dutA,59.54022988505747,
3938,CDS,1900079,1900514,1,435,dutA,59.54022988505747,
3939,gene,1901116,1901377,-1,261,cotU,75.47892720306514,
3940,CDS,1901116,1901377,-1,261,cotU,75.47892720306514,
3941,gene,1901611,1901737,1,126,ynzJ,65.87301587301587,
3942,misc_feature,1901611,1901737,1,126,ynzJ,65.87301587301587,
3943,gene,1901780,1901945,1,165,BSU_17679,70.9090909090909,
3944,CDS,1901780,1901945,1,165,BSU_17679,70.9090909090909,
3945,gene,1902218,1903058,1,840,thyA,61.54761904761905,
3946,CDS,1902218,1903058,1,840,thyA,61.54761904761905,
3947,gene,1903180,1903468,-1,288,BSU_17689,71.875,
3948,CDS,1903180,1903468,-1,288,BSU_17689,71.875,
3949,gene,1903510,1904233,-1,723,yncM,54.63347164591978,
3950,CDS,1903510,1904233,-1,723,yncM,54.63347164591978,
3951,gene,1904392,1904749,-1,357,ynzK,69.187675070028,
3952,CDS,1904392,1904749,-1,357,ynzK,69.187675070028,
3953,gene,1904994,1905195,-1,201,cotC,76.61691542288557,
3954,CDS,1904994,1905195,-1,201,cotC,76.61691542288557,
3955,gene,1905369,1905558,-1,189,tatAC,61.37566137566137,
3956,CDS,1905369,1905558,-1,189,tatAC,61.37566137566137,
3957,gene,1905636,1905774,1,138,BSU_17715,56.52173913043478,
3958,CDS,1905636,1905774,1,138,BSU_17715,56.52173913043478,
3959,gene,1905808,1906207,1,399,yndA,56.64160401002506,
3960,CDS,1905808,1906207,1,399,yndA,56.64160401002506,
3961,gene,1906271,1906706,-1,435,flvS,54.48275862068965,
3962,CDS,1906271,1906706,-1,435,flvS,54.48275862068965,
3963,gene,1907012,1907201,1,189,ynzB,59.25925925925925,
3964,CDS,1907012,1907201,1,189,ynzB,59.25925925925925,
3966,CDS,1907493,1909056,1,1563,yndD,57.26167626359565,
3965,gene,1907493,1909056,1,1563,yndD,57.26167626359565,
3967,gene,1909085,1910177,1,1092,yndE,59.61538461538461,
3968,CDS,1909085,1910177,1,1092,yndE,59.61538461538461,
3969,gene,1910166,1911381,1,1215,yndF,58.60082304526749,
3970,CDS,1910166,1911381,1,1215,yndF,58.60082304526749,
3971,gene,1911527,1912334,1,807,yndG,56.877323420074354,
3972,CDS,1911527,1912334,1,807,yndG,56.877323420074354,
3973,gene,1912338,1912956,1,618,yndH,60.84142394822006,
3974,CDS,1912338,1912956,1,618,yndH,60.84142394822006,
3975,gene,1912952,1914593,1,1641,yndJ,58.19622181596588,
3976,CDS,1912952,1914593,1,1641,yndJ,58.19622181596588,
3977,gene,1914629,1914995,1,366,yndK,63.114754098360656,
3978,CDS,1914629,1914995,1,366,yndK,63.114754098360656,
3979,gene,1914991,1915272,-1,281,surA,57.29537366548043,
3980,misc_RNA,1914991,1915272,-1,281,surA,57.29537366548043,
3981,gene,1915220,1915979,1,759,pghL,59.81554677206851,
3982,CDS,1915220,1915979,1,759,pghL,59.81554677206851,
3984,CDS,1916005,1916545,-1,540,yndM,62.40740740740741,
3983,gene,1916005,1916545,-1,540,yndM,62.40740740740741,
3986,CDS,1916662,1917097,1,435,fosB,62.98850574712643,
3985,gene,1916662,1917097,1,435,fosB,62.98850574712643,
3987,gene,1916954,1917302,1,348,yzzP,63.793103448275865,
3988,CDS,1916954,1917302,1,348,yzzP,63.793103448275865,
3989,gene,1917500,1917580,1,80,ncrF,53.75,
3990,misc_RNA,1917500,1917580,1,80,ncrF,53.75,
3992,CDS,1917638,1918256,-1,618,lexA,55.50161812297735,
3991,gene,1917638,1918256,-1,618,lexA,55.50161812297735,
3994,CDS,1918405,1918723,1,318,dinK,62.264150943396224,
3993,gene,1918405,1918723,1,318,dinK,62.264150943396224,
3995,gene,1918741,1919395,1,654,dinL,55.81039755351682,
3996,CDS,1918741,1919395,1,654,dinL,55.81039755351682,
3997,gene,1919458,1919692,1,234,ynzC,63.67521367521367,
3998,CDS,1919458,1919692,1,234,ynzC,63.67521367521367,
3999,gene,1919860,1921864,1,2004,tktA,54.740518962075846,
4000,CDS,1919860,1921864,1,2004,tktA,54.740518962075846,
4001,gene,1922016,1922463,1,447,pcfA,61.297539149888145,
4002,CDS,1922016,1922463,1,447,pcfA,61.297539149888145,
4004,CDS,1922548,1922767,1,219,yneF,63.4703196347032,
4003,gene,1922548,1922767,1,219,yneF,63.4703196347032,
4005,gene,1922840,1923014,-1,174,spo0D,58.620689655172406,
4006,CDS,1922840,1923014,-1,174,spo0D,58.620689655172406,
4007,gene,1923233,1923941,1,708,ccdA,58.05084745762712,
4008,CDS,1923233,1923941,1,708,ccdA,58.05084745762712,
4010,CDS,1924029,1924392,1,363,yneI,54.54545454545454,
4009,gene,1924029,1924392,1,363,yneI,54.54545454545454,
4011,gene,1924470,1924962,1,492,yneJ,65.2439024390244,
4012,CDS,1924470,1924962,1,492,yneJ,65.2439024390244,
4014,CDS,1924992,1925421,-1,429,yneK,61.3053613053613,
4013,gene,1924992,1925421,-1,429,yneK,61.3053613053613,
4015,gene,1925654,1926047,-1,393,cotM,62.086513994910945,
4016,CDS,1925654,1926047,-1,393,cotM,62.086513994910945,
4017,gene,1926127,1926274,-1,147,sspP,59.863945578231295,
4018,CDS,1926127,1926274,-1,147,sspP,59.863945578231295,
4020,CDS,1926305,1926452,-1,147,sspO,60.544217687074834,
4019,gene,1926305,1926452,-1,147,sspO,60.544217687074834,
4022,CDS,1926679,1929409,1,2730,citB,55.42124542124542,
4021,gene,1926679,1929409,1,2730,citB,55.42124542124542,
4023,gene,1929480,1929993,1,513,yneN,59.25925925925925,
4024,CDS,1929480,1929993,1,513,yneN,59.25925925925925,
4025,gene,1930073,1930199,1,126,ynzL,65.07936507936508,
4026,CDS,1930073,1930199,1,126,ynzL,65.07936507936508,
4027,gene,1930263,1930410,1,147,sspN,57.14285714285714,
4028,CDS,1930263,1930410,1,147,sspN,57.14285714285714,
4029,gene,1930446,1930698,1,252,sspT,61.904761904761905,
4030,CDS,1930446,1930698,1,252,sspT,61.904761904761905,
4031,gene,1930833,1931199,1,366,yneP,59.2896174863388,
4032,CDS,1930833,1931199,1,366,yneP,59.2896174863388,
4033,gene,1931214,1931514,1,300,yneQ,57.666666666666664,
4034,CDS,1931214,1931514,1,300,yneQ,57.666666666666664,
4036,CDS,1931544,1931832,-1,288,yneR,56.59722222222222,
4035,gene,1931544,1931832,-1,288,yneR,56.59722222222222,
4037,gene,1931919,1932501,-1,582,plsY,59.27835051546392,
4038,CDS,1931919,1932501,-1,582,plsY,59.27835051546392,
4039,gene,1932670,1933078,1,408,yneT,55.88235294117647,
4040,CDS,1932670,1933078,1,408,yneT,55.88235294117647,
4041,gene,1933476,1935444,1,1968,parE,54.166666666666664,
4042,CDS,1933476,1935444,1,1968,parE,54.166666666666664,
4043,gene,1935447,1937868,1,2421,parC,56.959933911606775,
4044,CDS,1935447,1937868,1,2421,parC,56.959933911606775,
4045,gene,1937914,1938091,-1,177,ynfCc,63.84180790960452,
4046,misc_feature,1937914,1938091,-1,177,ynfCc,63.84180790960452,
4047,gene,1938065,1938476,-1,411,ynfCn,58.3941605839416,
4048,misc_feature,1938065,1938476,-1,411,ynfCn,58.3941605839416,
4049,gene,1938924,1940322,1,1398,alsT,57.2961373390558,
4050,CDS,1938924,1940322,1,1398,alsT,57.2961373390558,
4051,gene,1940624,1942124,1,1500,eglS,56.733333333333334,
4052,CDS,1940624,1942124,1,1500,eglS,56.733333333333334,
4053,gene,1942191,1942455,1,264,ynfE,64.01515151515152,
4054,CDS,1942191,1942455,1,264,ynfE,64.01515151515152,
4055,gene,1942713,1943982,-1,1269,xynC,55.7919621749409,
4056,CDS,1942713,1943982,-1,1269,xynC,55.7919621749409,
4057,gene,1944112,1945654,-1,1542,xynD,53.56679636835279,
4058,CDS,1944112,1945654,-1,1542,xynD,53.56679636835279,
4059,gene,1946248,1946695,1,447,yngA,54.58612975391499,
4060,CDS,1946248,1946695,1,447,yngA,54.58612975391499,
4061,gene,1946701,1947595,1,894,yngB,53.914988814317674,
4062,CDS,1946701,1947595,1,894,yngB,53.914988814317674,
4063,gene,1947667,1948264,1,597,yngC,57.11892797319933,
4064,CDS,1947667,1948264,1,597,yngC,57.11892797319933,
4065,gene,1948312,1949512,-1,1200,nrnB,55.833333333333336,
4066,CDS,1948312,1949512,-1,1200,nrnB,55.833333333333336,
4067,gene,1949681,1951217,-1,1536,ldeE,52.1484375,
4068,CDS,1949681,1951217,-1,1536,ldeE,52.1484375,
4069,gene,1951227,1952010,-1,783,ldeF,52.10727969348659,
4070,CDS,1951227,1952010,-1,783,ldeF,52.10727969348659,
4071,gene,1952030,1952930,-1,900,ldeG,52.888888888888886,
4072,CDS,1952030,1952930,-1,900,ldeG,52.888888888888886,
4073,gene,1952944,1953166,-1,222,lgeHB,55.4054054054054,
4074,CDS,1952944,1953166,-1,222,lgeHB,55.4054054054054,
4075,gene,1953180,1954515,-1,1335,ldeHA,52.734082397003746,
4076,CDS,1953180,1954515,-1,1335,ldeHA,52.734082397003746,
4077,gene,1954524,1956174,-1,1650,ldeI,53.87878787878788,
4078,CDS,1954524,1956174,-1,1650,ldeI,53.87878787878788,
4079,gene,1956217,1957360,-1,1143,ldeJ,52.31846019247593,
4080,CDS,1956217,1957360,-1,1143,ldeJ,52.31846019247593,
4081,gene,1957450,1957756,-1,306,ynzE,55.55555555555556,
4082,CDS,1957450,1957756,-1,306,ynzE,55.55555555555556,
4083,gene,1957745,1957919,-1,174,BSU_18275,63.2183908045977,
4084,CDS,1957745,1957919,-1,174,BSU_18275,63.2183908045977,
4085,gene,1958026,1959559,-1,1533,yngK,56.62100456621004,
4086,CDS,1958026,1959559,-1,1533,yngK,56.62100456621004,
4087,gene,1959694,1960087,-1,393,yngL,60.05089058524173,
4088,CDS,1959694,1960087,-1,393,yngL,60.05089058524173,
4089,gene,1960197,1964037,-1,3840,ppsE,55.13020833333333,
4090,CDS,1960197,1964037,-1,3840,ppsE,55.13020833333333,
4091,gene,1964044,1974856,-1,10812,ppsD,53.153903070662224,
4092,CDS,1964044,1974856,-1,10812,ppsD,53.153903070662224,
4093,gene,1974880,1982548,-1,7668,ppsC,51.76056338028169,
4094,CDS,1974880,1982548,-1,7668,ppsC,51.76056338028169,
4095,gene,1982564,1990247,-1,7683,ppsB,54.83535077443706,
4096,CDS,1982564,1990247,-1,7683,ppsB,54.83535077443706,
4097,gene,1990271,1997957,-1,7686,ppsA,53.434816549570655,
4098,CDS,1990271,1997957,-1,7686,ppsA,53.434816549570655,
4099,gene,1998339,1999815,-1,1476,dacC,55.35230352303523,
4100,CDS,1998339,1999815,-1,1476,dacC,55.35230352303523,
4101,gene,1999848,2000826,-1,978,galM,55.72597137014314,
4102,CDS,1999848,2000826,-1,978,galM,55.72597137014314,
4103,gene,2000959,2002351,-1,1392,yoeA,55.962643678160916,
4104,CDS,2000959,2002351,-1,1392,yoeA,55.962643678160916,
4105,gene,2002636,2003182,1,546,iseA,64.46886446886447,
4106,CDS,2002636,2003182,1,546,iseA,64.46886446886447,
4107,gene,2003275,2003348,-1,73,trnSL-Arg1,46.57534246575342,
4108,tRNA,2003275,2003348,-1,73,trnSL-Arg1,46.57534246575342,
4109,gene,2003400,2003946,-1,546,yoeC,58.97435897435898,
4110,CDS,2003400,2003946,-1,546,yoeC,58.97435897435898,
4111,gene,2004261,2004492,-1,231,yoeD,62.77056277056276,
4112,CDS,2004261,2004492,-1,231,yoeD,62.77056277056276,
4113,gene,2004676,2006440,1,1764,ggt,56.12244897959183,
4114,CDS,2004676,2006440,1,1764,ggt,56.12244897959183,
4115,gene,2006540,2007398,-1,858,ftsR,55.59440559440559,
4116,CDS,2006540,2007398,-1,858,ftsR,55.59440559440559,
4117,gene,2007525,2008515,1,990,yogA,55.959595959595966,
4118,CDS,2007525,2008515,1,990,yogA,55.959595959595966,
4119,gene,2008571,2010053,-1,1482,gltB,53.50877192982456,
4120,CDS,2008571,2010053,-1,1482,gltB,53.50877192982456,
4121,gene,2010069,2014632,-1,4563,gltA,54.481700635546794,
4122,CDS,2010069,2014632,-1,4563,gltA,54.481700635546794,
4123,gene,2014778,2015681,1,903,gltC,57.25359911406424,
4124,CDS,2014778,2015681,1,903,gltC,57.25359911406424,
4125,gene,2015732,2016848,-1,1116,proJ,56.00358422939068,
4126,CDS,2015732,2016848,-1,1116,proJ,56.00358422939068,
4127,gene,2016844,2017738,-1,894,proH,55.257270693512304,
4128,CDS,2016844,2017738,-1,894,proH,55.257270693512304,
4129,gene,2017885,2018254,-1,369,rtp,63.68563685636857,
4130,CDS,2017885,2018254,-1,369,rtp,63.68563685636857,
4131,gene,2018553,2019270,-1,717,yoxD,55.23012552301255,
4132,CDS,2018553,2019270,-1,717,yoxD,55.23012552301255,
4133,gene,2019420,2019726,1,306,yoxC,60.78431372549019,
4134,CDS,2019420,2019726,1,306,yoxC,60.78431372549019,
4135,gene,2019796,2020567,1,771,yoxB,55.6420233463035,
4136,CDS,2019796,2020567,1,771,yoxB,55.6420233463035,
4137,gene,2020610,2021144,1,534,yoaA,57.865168539325836,
4138,CDS,2020610,2021144,1,534,yoaA,57.865168539325836,
4139,gene,2021222,2022467,-1,1245,yoaB,54.37751004016064,
4140,CDS,2021222,2022467,-1,1245,yoaB,54.37751004016064,
4141,gene,2022560,2024024,-1,1464,yoaC,54.91803278688525,
4142,CDS,2022560,2024024,-1,1464,yoaC,54.91803278688525,
4143,gene,2024041,2025076,-1,1035,yoaD,57.58454106280193,
4144,CDS,2024041,2025076,-1,1035,yoaD,57.58454106280193,
4145,gene,2025159,2025251,-1,92,mswF,52.17391304347826,
4146,misc_RNA,2025159,2025251,-1,92,mswF,52.17391304347826,
4147,gene,2025399,2027442,1,2043,yoaE,53.94028389623104,
4148,CDS,2025399,2027442,1,2043,yoaE,53.94028389623104,
4149,gene,2027508,2027802,1,294,yoaF,65.64625850340136,
4150,CDS,2027508,2027802,1,294,yoaF,65.64625850340136,
4151,gene,2028174,2028579,-1,405,yoaG,63.70370370370371,
4152,CDS,2028174,2028579,-1,405,yoaG,63.70370370370371,
4153,gene,2028664,2028784,-1,120,BSU_18595,60.0,
4154,CDS,2028664,2028784,-1,120,BSU_18595,60.0,
4155,gene,2028853,2028976,1,123,BSU_18596,68.29268292682927,
4156,CDS,2028853,2028976,1,123,BSU_18596,68.29268292682927,
4157,gene,2029019,2029313,1,294,yozQ,63.26530612244898,
4158,CDS,2029019,2029313,1,294,yozQ,63.26530612244898,
4159,gene,2029428,2031114,-1,1686,yoaH,60.14234875444839,
4160,CDS,2029428,2031114,-1,1686,yoaH,60.14234875444839,
4161,gene,2031438,2032890,1,1452,yoaI,62.46556473829201,
4162,CDS,2031438,2032890,1,1452,yoaI,62.46556473829201,
4163,gene,2032926,2033625,-1,699,exlX,55.22174535050072,
4164,CDS,2032926,2033625,-1,699,exlX,55.22174535050072,
4165,gene,2033894,2034572,-1,678,yoaK,59.29203539823009,
4166,CDS,2033894,2034572,-1,678,yoaK,59.29203539823009,
4167,gene,2034744,2035782,1,1038,pelB,61.175337186897885,
4168,CDS,2034744,2035782,1,1038,pelB,61.175337186897885,
4169,gene,2036038,2036722,1,684,yoaM,59.50292397660819,
4170,CDS,2036038,2036722,1,684,yoaM,59.50292397660819,
4171,gene,2037062,2037368,-1,306,yozS,64.37908496732027,
4172,CDS,2037062,2037368,-1,306,yozS,64.37908496732027,
4173,gene,2037600,2038779,-1,1179,oxdD,54.19847328244275,
4174,CDS,2037600,2038779,-1,1179,oxdD,54.19847328244275,
4175,gene,2038901,2039390,-1,489,yoaO,61.554192229038854,
4176,CDS,2038901,2039390,-1,489,yoaO,61.554192229038854,
4177,gene,2039414,2039570,-1,156,BSU_18689,71.7948717948718,
4178,CDS,2039414,2039570,-1,156,BSU_18689,71.7948717948718,
4179,gene,2039609,2040365,-1,756,yoaP,61.24338624338625,
4180,CDS,2039609,2040365,-1,756,yoaP,61.24338624338625,
4181,gene,2040672,2041029,1,357,yoaQ,67.22689075630252,
4182,CDS,2040672,2041029,1,357,yoaQ,67.22689075630252,
4183,gene,2040987,2041227,-1,240,yozT,65.41666666666667,
4184,CDS,2040987,2041227,-1,240,yozT,65.41666666666667,
4185,gene,2041329,2041827,-1,498,yozF,63.65461847389559,
4186,CDS,2041329,2041827,-1,498,yozF,63.65461847389559,
4187,gene,2041927,2042839,-1,912,yoaR,56.57894736842105,
4188,CDS,2041927,2042839,-1,912,yoaR,56.57894736842105,putative factor for cell wall maintenance or synthesis
4189,gene,2043185,2043668,1,483,yoaS,64.80331262939958,
4190,CDS,2043185,2043668,1,483,yoaS,64.80331262939958,
4191,gene,2043677,2043932,1,255,yozG,62.745098039215684,
4192,CDS,2043677,2043932,1,255,yozG,62.745098039215684,
4193,gene,2044037,2044832,1,795,yoaT,57.61006289308176,
4194,CDS,2044037,2044832,1,795,yoaT,57.61006289308176,
4195,gene,2044955,2045828,-1,873,yoaU,58.76288659793815,
4196,CDS,2044955,2045828,-1,873,yoaU,58.76288659793815,
4197,gene,2045928,2046807,1,879,yoaV,57.67918088737202,
4198,CDS,2045928,2046807,1,879,yoaV,57.67918088737202,
4199,gene,2046979,2047411,-1,432,yoaW,63.42592592592593,
4200,CDS,2046979,2047411,-1,432,yoaW,63.42592592592593,
4201,gene,2047674,2048307,-1,633,yoaZ,61.92733017377567,
4202,CDS,2047674,2048307,-1,633,yoaZ,61.92733017377567,
4203,gene,2048532,2049453,1,921,penP,57.32899022801303,
4204,CDS,2048532,2049453,1,921,penP,57.32899022801303,
4205,gene,2049949,2050312,-1,363,yobA,65.56473829201101,
4206,CDS,2049949,2050312,-1,363,yobA,65.56473829201101,
4207,gene,2050372,2050585,-1,213,yozU,64.31924882629107,
4208,misc_feature,2050372,2050585,-1,213,yozU,64.31924882629107,
4209,gene,2050688,2050952,1,264,yobB,62.121212121212125,
4210,CDS,2050688,2050952,1,264,yobB,62.121212121212125,
4211,gene,2051328,2053929,-1,2601,yppS,58.323721645520955,
4212,CDS,2051328,2053929,-1,2601,yppS,58.323721645520955,
4213,gene,2054598,2055240,-1,642,xynA,57.476635514018696,
4214,CDS,2054598,2055240,-1,642,xynA,57.476635514018696,
4215,gene,2055867,2056107,-1,240,yozV,66.25,
4216,CDS,2055867,2056107,-1,240,yozV,66.25,
4217,gene,2056277,2056616,1,339,yobD,66.07669616519173,
4218,CDS,2056277,2056616,1,339,yobD,66.07669616519173,
4219,gene,2056649,2057006,-1,357,yozH,68.0672268907563,
4220,CDS,2056649,2057006,-1,357,yozH,68.0672268907563,
4221,gene,2057213,2057579,1,366,yozI,67.4863387978142,
4222,CDS,2057213,2057579,1,366,yozI,67.4863387978142,
4223,gene,2057800,2058460,1,660,yobE,60.45454545454545,
4224,CDS,2057800,2058460,1,660,yobE,60.45454545454545,
4225,gene,2058714,2059638,-1,924,yobF,65.47619047619048,
4226,CDS,2058714,2059638,-1,924,yobF,65.47619047619048,
4227,gene,2059690,2059864,-1,174,yozW,59.77011494252874,
4228,CDS,2059690,2059864,-1,174,yozW,59.77011494252874,
4229,gene,2060008,2060233,1,225,yozX,65.77777777777779,
4230,CDS,2060008,2060233,1,225,yozX,65.77777777777779,
4231,gene,2060236,2060692,-1,456,yozJ,68.64035087719299,
4232,CDS,2060236,2060692,-1,456,yozJ,68.64035087719299,
4233,gene,2060816,2061077,1,261,yozY,66.28352490421456,
4234,CDS,2060816,2061077,1,261,yozY,66.28352490421456,
4235,gene,2061854,2061995,1,141,yozZ,65.95744680851064,
4236,misc_feature,2061854,2061995,1,141,yozZ,65.95744680851064,
4237,gene,2062149,2063265,1,1116,rapK,69.80286738351255,
4238,CDS,2062149,2063265,1,1116,rapK,69.80286738351255,
4239,gene,2063261,2063384,1,123,phrK,60.97560975609756,
4240,CDS,2063261,2063384,1,123,phrK,60.97560975609756,
4241,gene,2063509,2064163,-1,654,yobHc,60.85626911314985,
4242,misc_feature,2063509,2064163,-1,654,yobHc,60.85626911314985,
4243,gene,2064199,2064547,-1,348,yobHm,63.50574712643679,
4244,misc_feature,2064199,2064547,-1,348,yobHm,63.50574712643679,
4245,gene,2064539,2064833,-1,294,yozL,69.38775510204081,
4246,CDS,2064539,2064833,-1,294,yozL,69.38775510204081,
4248,CDS,2065041,2065377,1,336,yozM,68.15476190476191,
4247,gene,2065041,2065377,1,336,yozM,68.15476190476191,
4249,gene,2065423,2069029,-1,3606,yobI,70.41042706600112,
4250,CDS,2065423,2069029,-1,3606,yobI,70.41042706600112,
4251,gene,2069261,2069561,-1,300,yoyA,66.33333333333333,
4252,misc_feature,2069261,2069561,-1,300,yoyA,66.33333333333333,
4253,gene,2069731,2070115,-1,384,asrE,58.59375,
4254,misc_RNA,2069731,2070115,-1,384,asrE,58.59375,
4255,gene,2069882,2069975,1,93,bsrE,61.29032258064516,
4256,CDS,2069882,2069975,1,93,bsrE,61.29032258064516,
4257,gene,2070243,2071086,-1,843,yobJ,71.29300118623962,
4258,CDS,2070243,2071086,-1,843,yobJ,71.29300118623962,
4260,CDS,2071285,2071744,-1,459,rttM,65.14161220043573,
4259,gene,2071285,2071744,-1,459,rttM,65.14161220043573,
4261,gene,2071753,2073556,-1,1803,rttL,61.84137548530227,
4262,CDS,2071753,2073556,-1,1803,rttL,61.84137548530227,
4263,gene,2073657,2074215,-1,558,yobM,65.05376344086021,
4264,CDS,2073657,2074215,-1,558,yobM,65.05376344086021,
4266,CDS,2074342,2075779,1,1437,yobN,58.107167710508,
4265,gene,2074342,2075779,1,1437,yobN,58.107167710508,
4268,CDS,2076205,2078626,1,2421,yobO,58.03387030152829,
4267,gene,2076205,2078626,1,2421,yobO,58.03387030152829,
4269,gene,2079095,2079203,1,108,bsrF,49.074074074074076,
4270,misc_RNA,2079095,2079203,1,108,bsrF,49.074074074074076,
4271,gene,2079213,2079546,-1,333,csaA,51.051051051051054,
4272,CDS,2079213,2079546,-1,333,csaA,51.051051051051054,
4274,CDS,2079610,2080336,-1,726,yobQ,55.64738292011019,
4273,gene,2079610,2080336,-1,726,yobQ,55.64738292011019,
4275,gene,2080350,2081094,-1,744,yobR,56.048387096774185,
4276,CDS,2080350,2081094,-1,744,yobR,56.048387096774185,
4277,gene,2081171,2081747,-1,576,yobS,57.638888888888886,
4278,CDS,2081171,2081747,-1,576,yobS,57.638888888888886,
4279,gene,2081752,2082454,-1,702,yobT,52.56410256410257,
4280,CDS,2081752,2082454,-1,702,yobT,52.56410256410257,
4281,gene,2082530,2083013,-1,483,yobU,57.14285714285714,
4282,CDS,2082530,2083013,-1,483,yobU,57.14285714285714,
4284,CDS,2083066,2084008,-1,942,yobV,56.90021231422505,
4283,gene,2083066,2084008,-1,942,yobV,56.90021231422505,
4286,CDS,2084213,2084759,1,546,yobW,59.70695970695971,
4285,gene,2084213,2084759,1,546,yobW,59.70695970695971,
4287,gene,2084785,2085109,-1,324,czrA,57.407407407407405,
4288,CDS,2084785,2085109,-1,324,czrA,57.407407407407405,
4289,gene,2085302,2085980,1,678,yocA,60.17699115044248,
4290,CDS,2085302,2085980,1,678,yocA,60.17699115044248,
4292,CDS,2086069,2086606,-1,537,yozB,61.26629422718808,
4291,gene,2086069,2086606,-1,537,yozB,61.26629422718808,
4294,CDS,2086742,2087525,-1,783,yocB,57.47126436781609,
4293,gene,2086742,2087525,-1,783,yocB,57.47126436781609,
4295,gene,2087695,2088193,1,498,yocC,62.048192771084345,
4296,CDS,2087695,2088193,1,498,yocC,62.048192771084345,
4297,gene,2088256,2089234,1,978,yocD,58.48670756646217,
4298,CDS,2088256,2089234,1,978,yocD,58.48670756646217,
4299,gene,2089395,2090454,1,1059,desE,58.07365439093485,
4300,CDS,2089395,2090454,1,1059,desE,58.07365439093485,
4302,CDS,2090573,2091686,1,1113,desK,61.81491464510332,
4301,gene,2090573,2091686,1,1113,desK,61.81491464510332,
4304,CDS,2091704,2092304,1,600,desR,56.99999999999999,
4303,gene,2091704,2092304,1,600,desR,56.99999999999999,
4305,gene,2092898,2093762,-1,864,walL,58.333333333333336,
4306,CDS,2092898,2093762,-1,864,walL,58.333333333333336,exported cell wall lytic enzyme
4307,gene,2094009,2095785,-1,1776,recQ,56.58783783783784,
4308,CDS,2094009,2095785,-1,1776,recQ,56.58783783783784,
4309,gene,2095908,2096111,-1,203,ssrSA,58.620689655172406,
4310,misc_RNA,2095908,2096111,-1,203,ssrSA,58.620689655172406,
4311,gene,2096349,2096976,-1,627,azoJ,59.4896331738437,
4312,CDS,2096349,2096976,-1,627,azoJ,59.4896331738437,
4313,gene,2097125,2097617,-1,492,yocK,56.50406504065041,
4314,CDS,2097125,2097617,-1,492,yocK,56.50406504065041,
4315,gene,2097691,2098024,-1,333,yocL,57.35735735735735,
4316,CDS,2097691,2098024,-1,333,yocL,57.35735735735735,
4318,CDS,2098101,2098329,1,228,yoyB,59.64912280701754,
4317,gene,2098101,2098329,1,228,yoyB,59.64912280701754,
4319,gene,2098315,2098792,-1,477,yocM,59.538784067085956,
4320,CDS,2098315,2098792,-1,477,yocM,59.538784067085956,
4322,CDS,2098858,2099122,1,264,yozN,61.36363636363637,
4321,gene,2098858,2099122,1,264,yozN,61.36363636363637,
4323,gene,2099126,2099360,1,234,yocN,59.401709401709404,
4324,CDS,2099126,2099360,1,234,yocN,59.401709401709404,
4325,gene,2099445,2099790,-1,345,yozO,60.86956521739131,
4326,CDS,2099445,2099790,-1,345,yozO,60.86956521739131,
4327,gene,2100146,2100350,-1,204,yozC,66.66666666666666,
4328,CDS,2100146,2100350,-1,204,yozC,66.66666666666666,
4329,gene,2100579,2102067,1,1488,dhaS,52.553763440860216,
4330,CDS,2100579,2102067,1,1488,dhaS,52.553763440860216,
4331,gene,2102167,2104066,1,1899,sqhC,54.976303317535546,
4332,CDS,2102167,2104066,1,1899,sqhC,54.976303317535546,
4333,gene,2104055,2104901,1,846,sodF,56.02836879432624,
4334,CDS,2104055,2104901,1,846,sodF,56.02836879432624,
4335,gene,2104933,2106271,-1,1338,yocR,59.865470852017935,
4336,CDS,2104933,2106271,-1,1338,yocR,59.865470852017935,
4338,CDS,2106489,2107455,1,966,yocS,56.418219461697724,
4337,gene,2106489,2107455,1,966,yocS,56.418219461697724,
4340,CDS,2107504,2108758,-1,1254,odhB,54.94417862838915,
4339,gene,2107504,2108758,-1,1254,odhB,54.94417862838915,
4341,gene,2108773,2111608,-1,2835,odhA,53.72134038800706,
4342,CDS,2108773,2111608,-1,2835,odhA,53.72134038800706,
4343,gene,2111836,2113753,-1,1917,yojO,55.97287428273344,
4344,CDS,2111836,2113753,-1,1917,yojO,55.97287428273344,
4346,CDS,2113763,2114678,-1,915,yojN,57.267759562841526,
4345,gene,2113763,2114678,-1,915,yojN,57.267759562841526,
4348,CDS,2114741,2115332,-1,591,sodC,52.96108291032149,
4347,gene,2114741,2115332,-1,591,sodC,52.96108291032149,
4349,gene,2115424,2116669,-1,1245,cwlS,57.59036144578313,
4350,CDS,2115424,2116669,-1,1245,cwlS,57.59036144578313,"peptidoglycan hydrolase (cell wall-binding d,l-endopeptidase)"
4351,gene,2117050,2118268,-1,1218,yojK,59.195402298850574,
4352,CDS,2117050,2118268,-1,1218,yojK,59.195402298850574,
4354,CDS,2118503,2119127,-1,624,cdaS,54.96794871794872,
4353,gene,2118503,2119127,-1,624,cdaS,54.96794871794872,
4355,gene,2119392,2120751,1,1359,mdtK,55.114054451802794,
4356,CDS,2119392,2120751,1,1359,mdtK,55.114054451802794,
4358,CDS,2120766,2121615,1,849,rsbRC,60.18845700824499,
4357,gene,2120766,2121615,1,849,rsbRC,60.18845700824499,
4359,gene,2121640,2122306,-1,666,bshBB,57.05705705705706,
4360,CDS,2121640,2122306,-1,666,bshBB,57.05705705705706,
4361,gene,2122324,2122675,-1,351,yojF,57.26495726495726,
4362,CDS,2122324,2122675,-1,351,yojF,57.26495726495726,
4363,gene,2122671,2122950,-1,279,yoyC,56.63082437275986,
4364,CDS,2122671,2122950,-1,279,yoyC,56.63082437275986,
4366,CDS,2123025,2123922,-1,897,yojE,54.06911928651059,
4365,gene,2123025,2123922,-1,897,yojE,54.06911928651059,
4368,CDS,2124020,2124494,1,474,gerT,59.07172995780591,
4367,gene,2124020,2124494,1,474,gerT,59.07172995780591,
4369,gene,2124528,2124765,-1,237,yojB,46.41350210970464,
4370,CDS,2124528,2124765,-1,237,yojB,46.41350210970464,
4371,gene,2124849,2126184,-1,1335,yojA,54.157303370786515,
4372,CDS,2124849,2126184,-1,1335,yojA,54.157303370786515,
4374,CDS,2126548,2126938,1,390,yodA,57.43589743589743,
4373,gene,2126548,2126938,1,390,yodA,57.43589743589743,
4376,CDS,2127344,2127683,-1,339,arxR,53.98230088495575,
4375,gene,2127344,2127683,-1,339,arxR,53.98230088495575,
4377,gene,2127812,2128421,1,609,noxC,57.47126436781609,
4378,CDS,2127812,2128421,1,609,noxC,57.47126436781609,
4379,gene,2128463,2129066,-1,603,yodD,52.40464344941957,
4380,CDS,2128463,2129066,-1,603,yodD,52.40464344941957,
4381,gene,2129081,2129993,-1,912,yodE,54.71491228070175,
4382,CDS,2129081,2129993,-1,912,yodE,54.71491228070175,
4383,gene,2130176,2130377,1,201,yoyD,59.20398009950249,
4384,CDS,2130176,2130377,1,201,yoyD,59.20398009950249,
4385,gene,2130376,2131867,1,1491,yodF,54.862508383635145,
4386,CDS,2130376,2131867,1,1491,yodF,54.862508383635145,
4387,gene,2131901,2133302,-1,1401,ctpA,58.31548893647395,
4388,CDS,2131901,2133302,-1,1401,ctpA,58.31548893647395,
4390,CDS,2133454,2134156,1,702,yodH,55.84045584045584,
4389,gene,2133454,2134156,1,702,yodH,55.84045584045584,
4392,CDS,2134243,2134495,1,252,yodI,51.98412698412699,
4391,gene,2134243,2134495,1,252,yodI,51.98412698412699,
4393,gene,2134565,2135387,-1,822,ldcB,58.02919708029197,
4394,CDS,2134565,2135387,-1,822,ldcB,58.02919708029197,
4395,gene,2135469,2136171,-1,702,deoD,58.68945868945868,
4396,CDS,2135469,2136171,-1,702,deoD,58.68945868945868,
4397,gene,2136372,2136498,1,126,yoyE,58.730158730158735,
4398,CDS,2136372,2136498,1,126,yoyE,58.730158730158735,
4399,gene,2136537,2136852,-1,315,yodL,56.82539682539682,
4400,CDS,2136537,2136852,-1,315,yodL,56.82539682539682,
4401,gene,2136912,2137524,-1,612,pgpB,58.16993464052288,
4402,CDS,2136912,2137524,-1,612,pgpB,58.16993464052288,
4403,gene,2137601,2137778,-1,177,yozD,63.2768361581921,
4404,CDS,2137601,2137778,-1,177,yozD,63.2768361581921,
4406,CDS,2137896,2138040,1,144,yoyF,63.19444444444444,
4405,gene,2137896,2138040,1,144,yoyF,63.19444444444444,
4408,CDS,2138036,2138717,-1,681,yodN,62.55506607929515,
4407,gene,2138036,2138717,-1,681,yodN,62.55506607929515,
4409,gene,2138867,2139092,-1,225,yozE,59.111111111111114,
4410,CDS,2138867,2139092,-1,225,yozE,59.111111111111114,
4411,gene,2139178,2139457,-1,279,yokU,52.68817204301075,
4412,CDS,2139178,2139457,-1,279,yokU,52.68817204301075,
4414,CDS,2139453,2140869,-1,1416,kamA,54.94350282485876,
4413,gene,2139453,2140869,-1,1416,kamA,54.94350282485876,
4416,CDS,2140897,2141725,-1,828,kamB,54.347826086956516,
4415,gene,2140897,2141725,-1,828,kamB,54.347826086956516,
4417,gene,2141702,2143013,-1,1311,yodQ,52.707856598016775,
4418,CDS,2141702,2143013,-1,1311,yodQ,52.707856598016775,
4419,gene,2143021,2143675,-1,654,yodR,54.43425076452599,
4420,CDS,2143021,2143675,-1,654,yodR,54.43425076452599,
4421,gene,2143659,2144349,-1,690,yodS,50.0,
4422,CDS,2143659,2144349,-1,690,yodS,50.0,
4424,CDS,2144355,2145690,-1,1335,yodT,53.93258426966292,
4423,gene,2144355,2145690,-1,1335,yodT,53.93258426966292,
4426,CDS,2145670,2145826,-1,156,BSU_19745,60.256410256410255,
4425,gene,2145670,2145826,-1,156,BSU_19745,60.256410256410255,
4427,gene,2145819,2146053,-1,234,yoyG,61.53846153846154,
4428,CDS,2145819,2146053,-1,234,yoyG,61.53846153846154,
4429,gene,2146012,2146792,-1,780,cgeE,58.97435897435898,
4430,CDS,2146012,2146792,-1,780,cgeE,58.97435897435898,
4432,CDS,2146820,2148101,-1,1281,cgeD,59.640905542544886,
4431,gene,2146820,2148101,-1,1281,cgeD,59.640905542544886,
4434,CDS,2148165,2148471,-1,306,cgeC,61.111111111111114,
4433,gene,2148165,2148471,-1,306,cgeC,61.111111111111114,
4435,gene,2148675,2149077,1,402,cgeA,58.95522388059702,
4436,CDS,2148675,2149077,1,402,cgeA,58.95522388059702,
4437,gene,2149083,2150037,1,954,cgeB,57.127882599580715,
4438,CDS,2149083,2150037,1,954,cgeB,57.127882599580715,
4439,gene,2150107,2151256,-1,1149,phyC,55.96170583115752,
4440,CDS,2150107,2151256,-1,1149,phyC,55.96170583115752,
4442,misc_feature,2151625,2152045,1,420,spsMn,55.23809523809524,
4441,gene,2151625,2152045,1,420,spsMn,55.23809523809524,
4444,CDS,2152085,2152262,-1,177,sprB,67.79661016949152,
4443,gene,2152085,2152262,-1,177,sprB,67.79661016949152,
4445,gene,2152264,2152852,-1,588,yotM,64.79591836734694,
4446,CDS,2152264,2152852,-1,588,yotM,64.79591836734694,
4447,gene,2152926,2153169,1,243,yotL,67.07818930041152,
4448,CDS,2152926,2153169,1,243,yotL,67.07818930041152,
4449,gene,2153170,2153356,-1,186,yotK,65.59139784946237,
4450,CDS,2153170,2153356,-1,186,yotK,65.59139784946237,
4451,gene,2153439,2153652,-1,213,yotJ,69.48356807511738,
4452,CDS,2153439,2153652,-1,213,yotJ,69.48356807511738,
4453,gene,2153717,2154080,-1,363,yotI,70.24793388429752,
4454,CDS,2153717,2154080,-1,363,yotI,70.24793388429752,
4455,gene,2154076,2154250,-1,174,yotH,67.81609195402298,
4456,CDS,2154076,2154250,-1,174,yotH,67.81609195402298,
4457,gene,2154265,2154583,-1,318,yotG,68.55345911949685,
4458,CDS,2154265,2154583,-1,318,yotG,68.55345911949685,
4460,CDS,2154595,2154673,-1,78,yotF,73.07692307692307,
4459,gene,2154595,2154673,-1,78,yotF,73.07692307692307,
4462,CDS,2154704,2154851,-1,147,yotE,64.62585034013605,
4461,gene,2154704,2154851,-1,147,yotE,64.62585034013605,
4463,gene,2154780,2154972,1,192,BSU_19915,69.27083333333334,
4464,CDS,2154780,2154972,1,192,BSU_19915,69.27083333333334,
4465,gene,2154886,2155018,-1,132,yotD,68.93939393939394,
4466,CDS,2154886,2155018,-1,132,yotD,68.93939393939394,
4467,gene,2155057,2155249,-1,192,yotC,67.70833333333334,
4468,CDS,2155057,2155249,-1,192,yotC,67.70833333333334,
4469,gene,2155292,2156120,-1,828,yotB,64.00966183574879,
4470,CDS,2155292,2156120,-1,828,yotB,64.00966183574879,
4471,gene,2156238,2156457,1,219,sspC,62.10045662100456,
4472,CDS,2156238,2156457,1,219,sspC,62.10045662100456,
4473,gene,2156756,2157110,-1,354,yosX,68.64406779661016,
4474,CDS,2156756,2157110,-1,354,yosX,68.64406779661016,
4476,CDS,2157340,2157682,-1,342,yosW,65.78947368421053,
4475,gene,2157340,2157682,-1,342,yosW,65.78947368421053,
4478,CDS,2157828,2158119,-1,291,yosV,68.38487972508591,
4477,gene,2157828,2158119,-1,291,yosV,68.38487972508591,
4479,gene,2158119,2158287,-1,168,yojW,59.523809523809526,
4480,CDS,2158119,2158287,-1,168,yojW,59.523809523809526,
4481,gene,2158438,2158684,1,246,yosU,72.76422764227642,
4482,CDS,2158438,2158684,1,246,yosU,72.76422764227642,
4484,CDS,2158723,2159173,-1,450,yosT,66.44444444444444,
4483,gene,2158723,2159173,-1,450,yosT,66.44444444444444,
4486,CDS,2159267,2159696,-1,429,dutB,58.5081585081585,
4485,gene,2159267,2159696,-1,429,dutB,58.5081585081585,
4487,gene,2159741,2159984,-1,243,yosR,62.96296296296296,
4488,misc_feature,2159741,2159984,-1,243,yosR,62.96296296296296,
4489,gene,2159980,2161778,-1,1798,nrdFB,61.56840934371524,
4490,CDS,2159980,2161778,-1,1798,nrdFB,62.42424242424243,
4492,misc_RNA,2160389,2161194,-1,805,srdFi,60.372670807453424,
4491,gene,2160389,2161194,-1,805,srdFi,60.372670807453424,
4493,gene,2160564,2161086,-1,522,yosQ,65.51724137931035,
4494,CDS,2160564,2161086,-1,522,yosQ,65.51724137931035,
4496,CDS,2162107,2165614,-1,3507,nrdEB,63.74807987711214,
4495,gene,2162107,2165614,-1,3507,nrdEB,62.902765896777865,
4497,misc_feature,2163067,2164222,-1,1155,nrdEB,65.02164502164503,
4498,gene,2164642,2164894,-1,252,srdEi,51.98412698412699,
4499,misc_RNA,2164642,2164894,-1,252,srdEi,51.98412698412699,
4500,gene,2165576,2165972,-1,396,nrdIB,65.40404040404042,
4501,CDS,2165576,2165972,-1,396,nrdIB,65.40404040404042,
4502,gene,2165971,2166325,-1,354,yosL,64.12429378531074,
4503,CDS,2165971,2166325,-1,354,yosL,64.12429378531074,
4504,gene,2166412,2166613,-1,201,yosK,57.711442786069654,
4505,CDS,2166412,2166613,-1,201,yosK,57.711442786069654,
4506,gene,2166657,2166852,-1,195,yosJ,61.53846153846154,
4507,CDS,2166657,2166852,-1,195,yosJ,61.53846153846154,
4508,gene,2166872,2167007,-1,135,yosI,66.66666666666666,
4509,CDS,2166872,2167007,-1,135,yosI,66.66666666666666,
4511,CDS,2167038,2167509,-1,471,yosH,61.995753715498935,
4510,gene,2167038,2167509,-1,471,yosH,61.995753715498935,
4513,CDS,2167569,2167932,-1,363,yosG,66.39118457300276,
4512,gene,2167569,2167932,-1,363,yosG,66.39118457300276,
4514,gene,2167974,2168100,-1,126,yosF,67.46031746031747,
4515,CDS,2167974,2168100,-1,126,yosF,67.46031746031747,
4516,gene,2168113,2168461,-1,348,yosE,68.10344827586206,
4517,CDS,2168113,2168461,-1,348,yosE,68.10344827586206,
4519,CDS,2168475,2168871,-1,396,yosD,61.61616161616161,
4518,gene,2168475,2168871,-1,396,yosD,61.61616161616161,
4521,CDS,2168909,2169452,-1,543,yosC,64.64088397790056,
4520,gene,2168909,2169452,-1,543,yosC,64.64088397790056,
4522,gene,2169496,2169676,-1,180,yosB,64.44444444444444,
4523,CDS,2169496,2169676,-1,180,yosB,64.44444444444444,
4524,gene,2169806,2169926,1,120,yosA,55.833333333333336,
4525,CDS,2169806,2169926,1,120,yosA,55.833333333333336,
4526,gene,2170029,2170242,-1,213,yorZ,69.48356807511738,
4527,CDS,2170029,2170242,-1,213,yorZ,69.48356807511738,
4528,gene,2170308,2170491,-1,183,yorY,69.39890710382514,
4529,CDS,2170308,2170491,-1,183,yorY,69.39890710382514,
4530,gene,2170503,2170731,-1,228,yorX,64.03508771929825,
4531,CDS,2170503,2170731,-1,228,yorX,64.03508771929825,
4532,gene,2170770,2171136,-1,366,yorW,65.84699453551912,
4533,CDS,2170770,2171136,-1,366,yorW,65.84699453551912,
4535,CDS,2171138,2171357,-1,219,yorV,64.84018264840182,
4534,gene,2171138,2171357,-1,219,yorV,64.84018264840182,
4536,gene,2171400,2172732,-1,1332,mtbP,63.813813813813816,
4537,CDS,2171400,2172732,-1,1332,mtbP,63.813813813813816,
4538,gene,2172780,2172900,-1,120,yorT,70.0,
4539,CDS,2172780,2172900,-1,120,yorT,70.0,
4540,gene,2172931,2173450,-1,519,yorS,68.01541425818883,
4541,CDS,2172931,2173450,-1,519,yorS,68.01541425818883,
4542,gene,2173458,2173956,-1,498,yorR,64.2570281124498,
4543,CDS,2173458,2173956,-1,498,yorR,64.2570281124498,
4544,gene,2173955,2174111,-1,156,yorQ,64.74358974358975,
4545,CDS,2173955,2174111,-1,156,yorQ,64.74358974358975,
4547,CDS,2174103,2174319,-1,216,yorP,63.42592592592593,
4546,gene,2174103,2174319,-1,216,yorP,63.42592592592593,
4548,gene,2174351,2174549,-1,198,yorO,65.65656565656566,
4549,CDS,2174351,2174549,-1,198,yorO,65.65656565656566,
4550,gene,2174584,2174734,-1,150,yorN,63.33333333333333,
4551,CDS,2174584,2174734,-1,150,yorN,63.33333333333333,
4553,CDS,2174851,2175568,-1,717,yorM,67.36401673640168,
4552,gene,2174851,2175568,-1,717,yorM,67.36401673640168,
4555,CDS,2175595,2179513,-1,3918,dpoL,64.59928534966821,
4554,gene,2175595,2179513,-1,3918,dpoL,64.59928534966821,
4556,gene,2179525,2181256,-1,1731,yorK,65.8578856152513,
4557,CDS,2179525,2181256,-1,1731,yorK,65.8578856152513,
4558,gene,2181255,2182392,-1,1137,yorJ,65.61125769569041,
4559,CDS,2181255,2182392,-1,1137,yorJ,65.61125769569041,
4561,CDS,2182407,2183922,-1,1515,yorI,66.13861386138615,
4560,gene,2182407,2183922,-1,1515,yorI,66.13861386138615,
4562,gene,2183936,2184407,-1,471,yorH,65.39278131634819,
4563,CDS,2183936,2184407,-1,471,yorH,65.39278131634819,
4564,gene,2184449,2185421,-1,972,yorG,63.68312757201646,
4565,CDS,2184449,2185421,-1,972,yorG,63.68312757201646,
4566,gene,2185503,2186418,-1,915,yorF,65.79234972677595,
4567,CDS,2185503,2186418,-1,915,yorF,65.79234972677595,
4568,gene,2186439,2186811,-1,372,yorE,67.47311827956989,
4569,CDS,2186439,2186811,-1,372,yorE,67.47311827956989,
4571,CDS,2186984,2187299,-1,315,yorD,64.12698412698413,
4570,gene,2186984,2187299,-1,315,yorD,64.12698412698413,
4573,CDS,2187375,2187756,-1,381,yorC,66.40419947506561,
4572,gene,2187375,2187756,-1,381,yorC,66.40419947506561,
4574,gene,2187818,2188115,-1,297,yorB,65.65656565656566,
4575,CDS,2187818,2188115,-1,297,yorB,65.65656565656566,
4576,gene,2188203,2189964,-1,1761,yorA,63.94094264622374,
4577,CDS,2188203,2189964,-1,1761,yorA,63.94094264622374,
4579,CDS,2189960,2190785,-1,825,pghZ,62.18181818181818,
4578,gene,2189960,2190785,-1,825,pghZ,62.18181818181818,
4581,CDS,2190883,2191279,-1,396,yoqY,62.62626262626263,
4580,gene,2190883,2191279,-1,396,yoqY,62.62626262626263,
4582,gene,2191333,2191555,-1,222,yoqX,66.21621621621621,
4583,CDS,2191333,2191555,-1,222,yoqX,66.21621621621621,
4584,gene,2191625,2192300,1,675,yoqW,59.40740740740741,
4585,CDS,2191625,2192300,1,675,yoqW,59.40740740740741,
4586,gene,2192369,2193182,1,813,yoqV,62.11562115621157,
4587,CDS,2192369,2193182,1,813,yoqV,62.11562115621157,
4589,CDS,2193247,2193661,-1,414,yoqU,61.111111111111114,
4588,gene,2193247,2193661,-1,414,yoqU,61.111111111111114,
4591,CDS,2193826,2193976,1,150,yoqT,68.0,
4590,gene,2193826,2193976,1,150,yoqT,68.0,
4592,gene,2194052,2194400,-1,348,yoqS,66.0919540229885,
4593,CDS,2194052,2194400,-1,348,yoqS,66.0919540229885,
4594,gene,2194401,2194758,-1,357,yoqR,67.50700280112045,
4595,CDS,2194401,2194758,-1,357,yoqR,67.50700280112045,
4596,gene,2194717,2195059,-1,342,yoqP,64.03508771929825,
4597,CDS,2194717,2195059,-1,342,yoqP,64.03508771929825,
4598,gene,2195172,2195547,1,375,yoqO,66.4,
4599,CDS,2195172,2195547,1,375,yoqO,66.4,
4600,gene,2195563,2195782,-1,219,yoqN,61.64383561643836,
4601,CDS,2195563,2195782,-1,219,yoqN,61.64383561643836,
4602,gene,2195985,2196264,1,279,yoqM,67.74193548387096,
4603,CDS,2195985,2196264,1,279,yoqM,67.74193548387096,
4605,CDS,2196388,2197081,-1,693,yoqL,66.8109668109668,
4604,gene,2196388,2197081,-1,693,yoqL,66.8109668109668,
4606,gene,2197120,2197324,-1,204,yoqK,67.15686274509804,
4607,CDS,2197120,2197324,-1,204,yoqK,67.15686274509804,
4609,CDS,2197343,2197859,-1,516,yoqJ,65.50387596899225,
4608,gene,2197343,2197859,-1,516,yoqJ,65.50387596899225,
4610,gene,2198069,2198264,-1,195,yoqI,69.74358974358974,
4611,CDS,2198069,2198264,-1,195,yoqI,69.74358974358974,
4612,gene,2198312,2198765,-1,453,yoqH,61.36865342163355,
4613,CDS,2198312,2198765,-1,453,yoqH,61.36865342163355,
4614,gene,2198847,2199105,-1,258,yoqG,70.54263565891473,
4615,CDS,2198847,2199105,-1,258,yoqG,70.54263565891473,
4616,gene,2199149,2199353,-1,204,yoqF,65.19607843137256,
4617,CDS,2199149,2199353,-1,204,yoqF,65.19607843137256,
4618,gene,2199361,2199526,-1,165,yoqE,67.87878787878789,
4619,CDS,2199361,2199526,-1,165,yoqE,67.87878787878789,
4620,gene,2199579,2200335,-1,756,yoqD,64.28571428571429,
4621,CDS,2199579,2200335,-1,756,yoqD,64.28571428571429,
4623,CDS,2200375,2200783,-1,408,yoqC,65.44117647058823,
4622,gene,2200375,2200783,-1,408,yoqC,65.44117647058823,
4624,gene,2200789,2201128,-1,339,yoqB,64.30678466076697,
4625,CDS,2200789,2201128,-1,339,yoqB,64.30678466076697,
4627,CDS,2201124,2201475,-1,351,yoqA,61.82336182336182,
4626,gene,2201124,2201475,-1,351,yoqA,61.82336182336182,
4628,gene,2201487,2201691,-1,204,yopZ,59.80392156862745,
4629,CDS,2201487,2201691,-1,204,yopZ,59.80392156862745,
4631,CDS,2201704,2201983,-1,279,yopY,69.17562724014337,
4630,gene,2201704,2201983,-1,279,yopY,69.17562724014337,
4632,gene,2201979,2202384,-1,405,yopX,59.25925925925925,
4633,CDS,2201979,2202384,-1,405,yopX,59.25925925925925,
4635,CDS,2202380,2202716,-1,336,yopW,67.85714285714286,
4634,gene,2202380,2202716,-1,336,yopW,67.85714285714286,
4636,gene,2202804,2202999,-1,195,yopV,67.6923076923077,
4637,CDS,2202804,2202999,-1,195,yopV,67.6923076923077,
4638,gene,2203110,2203308,-1,198,yopU,69.6969696969697,
4639,CDS,2203110,2203308,-1,198,yopU,69.6969696969697,
4641,CDS,2203377,2203596,-1,219,yopT,69.40639269406392,
4640,gene,2203377,2203596,-1,219,yopT,69.40639269406392,
4643,CDS,2203778,2204003,1,225,yopS,64.88888888888889,
4642,gene,2203778,2204003,1,225,yopS,64.88888888888889,
4645,CDS,2204191,2205169,-1,978,yopR,69.12065439672801,
4644,gene,2204191,2205169,-1,978,yopR,69.12065439672801,
4646,gene,2205192,2206575,-1,1383,yopQ,67.6066522053507,
4647,CDS,2205192,2206575,-1,1383,yopQ,67.6066522053507,
4649,CDS,2206681,2207758,-1,1077,yopP,66.01671309192201,
4648,gene,2206681,2207758,-1,1077,yopP,66.01671309192201,
4650,gene,2207747,2207960,-1,213,yopO,63.84976525821596,
4651,CDS,2207747,2207960,-1,213,yopO,63.84976525821596,
4652,gene,2208007,2208325,-1,318,yopN,71.38364779874213,
4653,CDS,2208007,2208325,-1,318,yopN,71.38364779874213,
4655,CDS,2208327,2208528,-1,201,yopM,72.636815920398,
4654,gene,2208327,2208528,-1,201,yopM,72.636815920398,
4656,gene,2208589,2208880,-1,291,aimX,69.41580756013745,
4657,ncRNA,2208589,2208880,-1,291,aimX,69.41580756013745,
4659,CDS,2208854,2208980,-1,126,aimP,59.523809523809526,
4658,gene,2208854,2208980,-1,126,aimP,59.523809523809526,
4660,gene,2208993,2210154,-1,1161,aimR,68.90611541774334,
4661,CDS,2208993,2210154,-1,1161,aimR,68.90611541774334,
4663,CDS,2210330,2210747,-1,417,yopJ,63.78896882494005,
4662,gene,2210330,2210747,-1,417,yopJ,63.78896882494005,
4664,gene,2210748,2211282,-1,534,yopI,69.85018726591761,
4665,CDS,2210748,2211282,-1,534,yopI,69.85018726591761,
4666,gene,2211308,2211845,-1,537,sieB,67.0391061452514,
4667,CDS,2211308,2211845,-1,537,sieB,67.0391061452514,
4668,gene,2211883,2212015,-1,132,yopG,59.84848484848485,
4669,CDS,2211883,2212015,-1,132,yopG,59.84848484848485,
4670,gene,2212025,2212241,-1,216,yopF,65.74074074074075,
4671,CDS,2212025,2212241,-1,216,yopF,65.74074074074075,
4672,gene,2212244,2212496,-1,252,yopE,67.85714285714286,
4673,CDS,2212244,2212496,-1,252,yopE,67.85714285714286,
4674,gene,2212566,2212746,1,180,yoyH,63.33333333333333,
4675,CDS,2212566,2212746,1,180,yoyH,63.33333333333333,
4677,CDS,2212847,2213078,1,231,yoyI,67.53246753246754,
4676,gene,2212847,2213078,1,231,yoyI,67.53246753246754,
4679,CDS,2213082,2213478,-1,396,yopD,64.64646464646465,
4678,gene,2213082,2213478,-1,396,yopD,64.64646464646465,
4680,gene,2213535,2214864,-1,1329,yopC,68.47253574115877,
4681,CDS,2213535,2214864,-1,1329,yopC,68.47253574115877,
4682,gene,2214971,2215199,-1,228,yopB,63.59649122807017,
4683,CDS,2214971,2215199,-1,228,yopB,63.59649122807017,
4684,gene,2215459,2216776,-1,1317,yopA,67.50189825360668,
4685,CDS,2215459,2216776,-1,1317,yopA,67.50189825360668,
4686,gene,2217132,2217639,-1,507,yonX,64.69428007889546,
4687,CDS,2217132,2217639,-1,507,yonX,64.69428007889546,
4688,gene,2217966,2219199,-1,1233,yonV,68.61313868613139,
4689,CDS,2217966,2219199,-1,1233,yonV,68.61313868613139,
4690,gene,2219280,2219469,-1,189,yonU,66.13756613756614,
4691,CDS,2219280,2219469,-1,189,yonU,66.13756613756614,
4693,CDS,2219513,2219765,-1,252,yoyJ,65.87301587301587,
4692,gene,2219513,2219765,-1,252,yoyJ,65.87301587301587,
4695,misc_RNA,2219742,2219849,1,107,apbT,54.20560747663551,
4694,gene,2219742,2219849,1,107,apbT,54.20560747663551,
4696,gene,2219783,2219960,-1,177,spbT,58.19209039548022,
4697,CDS,2219783,2219960,-1,177,spbT,58.19209039548022,
4698,gene,2220334,2220946,-1,612,yonS,63.888888888888886,
4699,CDS,2220334,2220946,-1,612,yonS,63.888888888888886,
4701,CDS,2221060,2221387,-1,327,yonR,64.83180428134557,
4700,gene,2221060,2221387,-1,327,yonR,64.83180428134557,
4703,CDS,2222339,2222534,1,195,yonP,71.7948717948718,
4702,gene,2222339,2222534,1,195,yonP,71.7948717948718,
4704,gene,2222573,2225093,1,2520,yonO,65.75396825396825,
4705,CDS,2222573,2225093,1,2520,yonO,65.75396825396825,
4706,gene,2225336,2225615,1,279,hupN,59.85663082437276,
4707,CDS,2225336,2225615,1,279,hupN,59.85663082437276,
4708,gene,2226175,2226346,1,171,BSU_21058,58.47953216374269,
4709,CDS,2226175,2226346,1,171,BSU_21058,58.47953216374269,
4711,CDS,2227296,2227488,1,192,yonK,70.83333333333334,
4710,gene,2227296,2227488,1,192,yonK,70.83333333333334,
4713,CDS,2227504,2228722,1,1218,yonJ,63.2183908045977,
4712,gene,2227504,2228722,1,1218,yonJ,63.2183908045977,
4714,gene,2228755,2229166,-1,411,yonI,68.85644768856449,
4715,CDS,2228755,2229166,-1,411,yonI,68.85644768856449,
4716,gene,2229384,2229885,1,501,yonH,67.26546906187625,
4717,CDS,2229384,2229885,1,501,yonH,67.26546906187625,
4719,CDS,2229987,2230908,1,921,yonG,63.952225841476654,
4718,gene,2229987,2230908,1,921,yonG,63.952225841476654,
4721,CDS,2230894,2232664,1,1770,yonF,63.61581920903955,
4720,gene,2230894,2232664,1,1770,yonF,63.61581920903955,
4722,gene,2232681,2234202,1,1521,yonE,64.1025641025641,
4723,CDS,2232681,2234202,1,1521,yonE,64.1025641025641,
4724,gene,2234232,2235669,1,1437,yonD,65.27487821851079,
4725,CDS,2234232,2235669,1,1437,yonD,65.27487821851079,
4726,gene,2235693,2236230,1,537,yonC,62.94227188081937,
4727,CDS,2235693,2236230,1,537,yonC,62.94227188081937,
4729,CDS,2236268,2237285,1,1017,yonB,62.14355948869223,
4728,gene,2236268,2237285,1,1017,yonB,62.14355948869223,
4731,CDS,2237320,2237791,1,471,yonA,64.75583864118896,
4730,gene,2237320,2237791,1,471,yonA,64.75583864118896,
4732,gene,2237805,2238201,1,396,yomZ,63.888888888888886,
4733,CDS,2237805,2238201,1,396,yomZ,63.888888888888886,
4734,gene,2238197,2238452,1,255,yomY,65.49019607843137,
4735,CDS,2238197,2238452,1,255,yomY,65.49019607843137,
4736,gene,2238435,2239086,1,651,yomX,64.36251920122888,
4737,CDS,2238435,2239086,1,651,yomX,64.36251920122888,
4738,gene,2239082,2239589,1,507,yomW,64.89151873767258,
4739,CDS,2239082,2239589,1,507,yomW,64.89151873767258,
4740,gene,2239585,2240296,1,711,yomV,65.40084388185655,
4741,CDS,2239585,2240296,1,711,yomV,65.40084388185655,
4742,gene,2240338,2241136,1,798,yomU,61.65413533834586,
4743,CDS,2240338,2241136,1,798,yomU,61.65413533834586,
4745,CDS,2241153,2241765,1,612,youA,62.58169934640523,
4744,gene,2241153,2241765,1,612,youA,62.58169934640523,
4747,CDS,2241764,2241992,1,228,yomT,60.96491228070175,
4746,gene,2241764,2241992,1,228,yomT,60.96491228070175,
4749,CDS,2242055,2242412,1,357,yomS,61.904761904761905,
4748,gene,2242055,2242412,1,357,yomS,61.904761904761905,
4750,gene,2242413,2243631,1,1218,yomR,62.80788177339901,
4751,CDS,2242413,2243631,1,1218,yomR,62.80788177339901,
4752,gene,2243641,2243992,1,351,yomQ,64.67236467236467,
4753,CDS,2243641,2243992,1,351,yomQ,64.67236467236467,
4754,gene,2243988,2244180,1,192,yomP,66.14583333333334,
4755,CDS,2243988,2244180,1,192,yomP,66.14583333333334,
4757,CDS,2244229,2244730,1,501,yomO,68.06387225548902,
4756,gene,2244229,2244730,1,501,yomO,68.06387225548902,
4758,gene,2244713,2245133,1,420,yomN,62.142857142857146,
4759,CDS,2244713,2245133,1,420,yomN,62.142857142857146,
4760,gene,2245146,2246148,1,1002,yomM,62.27544910179641,
4761,CDS,2245146,2246148,1,1002,yomM,62.27544910179641,
4763,CDS,2246150,2246480,-1,330,yozP,63.93939393939394,
4762,gene,2246150,2246480,-1,330,yozP,63.93939393939394,
4765,CDS,2246655,2247342,-1,687,yomL,63.75545851528385,
4764,gene,2246655,2247342,-1,687,yomL,63.75545851528385,
4767,CDS,2247366,2247543,-1,177,youB,72.31638418079096,
4766,gene,2247366,2247543,-1,177,youB,72.31638418079096,
4768,gene,2247888,2248335,1,447,yomK,69.79865771812081,
4769,CDS,2247888,2248335,1,447,yomK,69.79865771812081,
4771,CDS,2248416,2249100,1,684,yomJ,65.35087719298247,
4770,gene,2248416,2249100,1,684,yomJ,65.35087719298247,
4772,gene,2249153,2256011,1,6858,cwlP,62.627588218139394,
4773,CDS,2249153,2256011,1,6858,cwlP,62.627588218139394,
4774,gene,2256061,2256820,1,759,yomH,68.37944664031622,
4775,CDS,2256061,2256820,1,759,yomH,68.37944664031622,
4777,CDS,2256831,2259459,1,2628,yomG,63.39421613394216,
4776,gene,2256831,2259459,1,2628,yomG,63.39421613394216,
4778,gene,2259474,2260296,1,822,yomF,63.625304136253035,
4779,CDS,2259474,2260296,1,822,yomF,63.625304136253035,
4781,CDS,2260332,2262267,1,1935,yomE,62.997416020671835,
4780,gene,2260332,2262267,1,1935,yomE,62.997416020671835,
4782,gene,2262436,2263261,1,825,yomD,65.57575757575758,
4783,CDS,2262436,2263261,1,825,yomD,65.57575757575758,
4785,CDS,2263250,2263469,1,219,BSU_21409,67.57990867579909,
4784,gene,2263250,2263469,1,219,BSU_21409,67.57990867579909,
4786,gene,2263488,2264592,1,1104,blyA,62.40942028985508,
4787,CDS,2263488,2264592,1,1104,blyA,62.40942028985508,
4789,CDS,2264679,2264892,1,213,bhlA,68.54460093896714,
4788,gene,2264679,2264892,1,213,bhlA,68.54460093896714,
4790,gene,2264902,2265169,1,267,bhlB,68.53932584269663,
4791,CDS,2264902,2265169,1,267,bhlB,68.53932584269663,
4792,gene,2265224,2265671,-1,447,bdbB,72.25950782997764,
4793,CDS,2265224,2265671,-1,447,bdbB,72.25950782997764,
4794,gene,2265667,2266936,-1,1269,sunS,71.94641449960599,
4795,CDS,2265667,2266936,-1,1269,sunS,71.94641449960599,
4796,gene,2266935,2267349,-1,414,bdbA,73.42995169082126,
4797,CDS,2266935,2267349,-1,414,bdbA,73.42995169082126,
4799,CDS,2267345,2269463,-1,2118,sunT,71.15203021718602,
4798,gene,2267345,2269463,-1,2118,sunT,71.15203021718602,
4801,CDS,2269520,2269691,-1,171,sunA,57.89473684210527,
4800,gene,2269520,2269691,-1,171,sunA,57.89473684210527,
4802,gene,2269987,2270305,-1,318,sunI,73.89937106918238,
4803,CDS,2269987,2270305,-1,318,sunI,73.89937106918238,
4804,gene,2270406,2271657,-1,1251,uvrX,60.59152677857714,
4805,CDS,2270406,2271657,-1,1251,uvrX,60.59152677857714,
4806,gene,2271649,2271982,-1,333,yolD,66.66666666666666,
4807,CDS,2271649,2271982,-1,333,yolD,66.66666666666666,
4809,CDS,2272155,2272491,1,336,yolC,67.55952380952381,
4808,gene,2272155,2272491,1,336,yolC,67.55952380952381,
4810,gene,2272533,2272890,-1,357,yolB,68.0672268907563,
4811,CDS,2272533,2272890,-1,357,yolB,68.0672268907563,
4812,gene,2272895,2273363,-1,468,yolA,62.39316239316239,
4813,CDS,2272895,2273363,-1,468,yolA,62.39316239316239,
4814,gene,2273593,2273710,1,117,bsrG,70.94017094017094,
4815,CDS,2273593,2273710,1,117,bsrG,70.94017094017094,
4816,gene,2273704,2273884,-1,180,asrG,61.66666666666667,
4817,misc_RNA,2273704,2273884,-1,180,asrG,61.66666666666667,
4819,CDS,2273988,2274522,-1,534,yokL,65.91760299625467,
4818,gene,2273988,2274522,-1,534,yokL,65.91760299625467,
4821,CDS,2274557,2275136,-1,579,yokK,65.63039723661485,
4820,gene,2274557,2275136,-1,579,yokK,65.63039723661485,
4822,gene,2275199,2275697,-1,498,yokJ,62.65060240963856,
4823,CDS,2275199,2275697,-1,498,yokJ,62.65060240963856,
4824,gene,2275705,2277421,-1,1716,yokI,61.13053613053613,
4825,CDS,2275705,2277421,-1,1716,yokI,61.13053613053613,
4826,gene,2277520,2278078,-1,558,yokH,65.23297491039428,
4827,CDS,2277520,2278078,-1,558,yokH,65.23297491039428,
4828,gene,2278107,2278347,1,240,yoyK,70.0,
4829,misc_feature,2278107,2278347,1,240,yoyK,70.0,
4830,gene,2278339,2278456,1,117,yoyK,70.94017094017094,
4831,misc_feature,2278339,2278456,1,117,yoyK,70.94017094017094,
4832,gene,2278601,2279675,-1,1074,yokG,66.57355679702049,
4833,CDS,2278601,2279675,-1,1074,yokG,66.57355679702049,
4835,CDS,2279976,2280867,1,891,nukF,61.05499438832772,
4834,gene,2279976,2280867,1,891,nukF,61.05499438832772,
4837,CDS,2280880,2281363,1,483,yokE,67.70186335403726,
4836,gene,2280880,2281363,1,483,yokE,67.70186335403726,
4838,gene,2281666,2282485,1,819,aacD,63.98046398046397,
4839,CDS,2281666,2282485,1,819,aacD,63.98046398046397,
4840,gene,2282504,2282639,-1,135,BSU_21638,65.18518518518519,
4841,CDS,2282504,2282639,-1,135,BSU_21638,65.18518518518519,
4843,CDS,2282800,2282956,-1,156,BSU_21639,68.58974358974359,
4842,gene,2282800,2282956,-1,156,BSU_21639,68.58974358974359,
4845,CDS,2283135,2283651,-1,516,yokC,67.24806201550388,
4844,gene,2283135,2283651,-1,516,yokC,67.24806201550388,
4846,gene,2283857,2284568,-1,711,yokB,65.68213783403657,
4847,CDS,2283857,2284568,-1,711,yokB,65.68213783403657,
4848,gene,2284770,2286408,1,1638,sprA,65.87301587301587,
4849,CDS,2284770,2286408,1,1638,sprA,65.87301587301587,
4850,gene,2286447,2287053,1,606,spsMc,56.10561056105611,
4851,misc_feature,2286447,2287053,1,606,spsMc,56.10561056105611,
4853,CDS,2287096,2287528,-1,432,msrB,58.333333333333336,
4852,gene,2287096,2287528,-1,432,msrB,58.333333333333336,
4855,CDS,2287528,2288062,-1,534,msrA,54.68164794007491,
4854,gene,2287528,2288062,-1,534,msrA,54.68164794007491,
4856,gene,2288193,2288619,1,426,ypoP,59.859154929577464,
4857,CDS,2288193,2288619,1,426,ypoP,59.859154929577464,
4858,gene,2288668,2290006,-1,1338,dinF,55.30642750373692,
4859,CDS,2288668,2290006,-1,1338,dinF,55.30642750373692,
4861,CDS,2290077,2290272,-1,195,ypmT,62.05128205128205,
4860,gene,2290077,2290272,-1,195,ypmT,62.05128205128205,
4863,CDS,2290284,2290848,-1,564,ypmS,61.87943262411347,
4862,gene,2290284,2290848,-1,564,ypmS,61.87943262411347,
4864,gene,2290857,2291625,-1,768,ypmR,60.677083333333336,
4865,CDS,2290857,2291625,-1,768,ypmR,60.677083333333336,
4866,gene,2291702,2292284,-1,582,scuA,58.591065292096225,
4867,CDS,2291702,2292284,-1,582,scuA,58.591065292096225,
4868,gene,2292431,2292683,-1,252,ypmP,60.71428571428571,
4869,CDS,2292431,2292683,-1,252,ypmP,60.71428571428571,
4871,CDS,2292768,2294037,-1,1269,ilvA,55.94956658786446,
4870,gene,2292768,2294037,-1,1269,ilvA,55.94956658786446,
4873,CDS,2294285,2295281,1,996,silP,57.22891566265061,
4872,gene,2294285,2295281,1,996,silP,57.22891566265061,
4874,gene,2295301,2295943,1,642,yplQ,55.9190031152648,
4875,CDS,2295301,2295943,1,642,yplQ,55.9190031152648,
4876,gene,2295981,2296602,-1,621,ypkP,57.1658615136876,
4877,CDS,2295981,2296602,-1,621,ypkP,57.1658615136876,
4878,gene,2296602,2297109,-1,507,dfrA,57.59368836291914,
4879,CDS,2296602,2297109,-1,507,dfrA,57.59368836291914,
4880,gene,2297105,2297900,-1,795,thyB,55.84905660377358,
4881,CDS,2297105,2297900,-1,795,thyB,55.84905660377358,
4882,gene,2297983,2298517,-1,534,ypjQ,58.052434456928836,
4883,CDS,2297983,2298517,-1,534,ypjQ,58.052434456928836,
4884,gene,2298534,2299146,-1,612,ypjP,54.248366013071895,
4885,CDS,2298534,2299146,-1,612,ypjP,54.248366013071895,
4886,gene,2299405,2300179,-1,774,rsmJ,54.39276485788114,
4887,CDS,2299405,2300179,-1,774,rsmJ,54.39276485788114,
4889,CDS,2300220,2300655,-1,435,brxA,52.41379310344828,
4888,gene,2300220,2300655,-1,435,brxA,52.41379310344828,
4891,CDS,2300761,2302438,-1,1677,ilvD,50.924269528920696,
4890,gene,2300761,2302438,-1,1677,ilvD,50.924269528920696,
4892,gene,2302726,2303860,-1,1134,ypgR,54.58553791887125,
4893,CDS,2302726,2303860,-1,1134,ypgR,54.58553791887125,
4894,gene,2303919,2304537,-1,618,hdhQ,54.53074433656958,
4895,CDS,2303919,2304537,-1,618,hdhQ,54.53074433656958,
4897,CDS,2304552,2305035,-1,483,bsaA,58.38509316770186,
4896,gene,2304552,2305035,-1,483,bsaA,58.38509316770186,
4899,CDS,2305377,2306283,1,906,metAA,59.16114790286976,
4898,gene,2305377,2306283,1,906,metAA,59.16114790286976,
4900,gene,2306513,2307662,1,1149,ugtP,59.87815491731941,
4901,CDS,2306513,2307662,1,1149,ugtP,59.87815491731941,
4902,gene,2307742,2307889,1,147,BSU_21925,61.904761904761905,
4903,CDS,2307742,2307889,1,147,BSU_21925,61.904761904761905,
4905,CDS,2307904,2308105,1,201,cspD,62.68656716417911,
4904,gene,2307904,2308105,1,201,cspD,62.68656716417911,
4906,gene,2308156,2308339,-1,183,degR,67.21311475409836,
4907,CDS,2308156,2308339,-1,183,degR,67.21311475409836,
4909,CDS,2308494,2308764,1,270,ypzA,52.22222222222223,
4908,gene,2308494,2308764,1,270,ypzA,52.22222222222223,
4910,gene,2308791,2308974,-1,183,ypeQ,66.66666666666666,
4911,CDS,2308791,2308974,-1,183,ypeQ,66.66666666666666,
4912,gene,2308966,2309647,-1,681,ypeP,54.77239353891336,
4913,CDS,2308966,2309647,-1,681,ypeP,54.77239353891336,
4914,gene,2309729,2310419,1,690,queP,57.68115942028985,
4915,CDS,2309729,2310419,1,690,queP,57.68115942028985,
4917,CDS,2310418,2310817,1,399,ypdQ,57.393483709273184,
4916,gene,2310418,2310817,1,399,ypdQ,57.393483709273184,
4919,CDS,2310858,2310987,1,129,sspL,54.263565891472865,
4918,gene,2310858,2310987,1,129,sspL,54.263565891472865,
4920,gene,2310994,2311885,-1,891,exnP,54.7699214365881,
4921,CDS,2310994,2311885,-1,891,exnP,54.7699214365881,
4922,gene,2311985,2312132,-1,147,ypzF,55.78231292517006,
4923,CDS,2311985,2312132,-1,147,ypzF,55.78231292517006,
4925,CDS,2312206,2312464,-1,258,ypbS,60.46511627906976,
4924,gene,2312206,2312464,-1,258,ypbS,60.46511627906976,
4927,CDS,2312528,2316110,-1,3582,dynA,56.78391959798995,
4926,gene,2312528,2316110,-1,3582,dynA,56.78391959798995,
4928,gene,2316285,2316375,-1,90,fbpC,70.0,
4929,CDS,2316285,2316375,-1,90,fbpC,70.0,
4930,gene,2316445,2316952,-1,507,bpsB,57.396449704142015,
4931,CDS,2316445,2316952,-1,507,bpsB,57.396449704142015,
4932,gene,2316955,2318053,-1,1098,bpsA,54.644808743169406,
4933,CDS,2316955,2318053,-1,1098,bpsA,54.644808743169406,
4934,gene,2318126,2319443,-1,1317,pbuX,55.20121488230828,
4935,CDS,2318126,2319443,-1,1317,pbuX,55.20121488230828,
4936,gene,2319439,2320024,-1,585,xpt,55.38461538461539,
4937,CDS,2319439,2320024,-1,585,xpt,55.38461538461539,
4938,gene,2320112,2320213,-1,101,gswA,54.45544554455446,
4939,misc_RNA,2320112,2320213,-1,101,gswA,54.45544554455446,
4941,CDS,2320354,2321860,-1,1506,ypwA,57.90172642762285,
4940,gene,2320354,2321860,-1,1506,ypwA,57.90172642762285,
4943,CDS,2321971,2322964,-1,993,kdgT,51.560926485397786,
4942,gene,2321971,2322964,-1,993,kdgT,51.560926485397786,
4944,gene,2323008,2323599,-1,591,kdgA,51.26903553299492,
4945,CDS,2323008,2323599,-1,591,kdgA,51.26903553299492,
4946,gene,2323600,2324575,-1,975,kdgK,51.8974358974359,
4947,CDS,2323600,2324575,-1,975,kdgK,51.8974358974359,
4949,CDS,2324612,2325632,-1,1020,kdgR,56.568627450980394,
4948,gene,2324612,2325632,-1,1020,kdgR,56.568627450980394,
4951,CDS,2325853,2326681,1,828,kduI,55.55555555555556,
4950,gene,2325853,2326681,1,828,kduI,55.55555555555556,
4952,gene,2326682,2327447,1,765,kduD,52.02614379084968,
4953,CDS,2326682,2327447,1,765,kduD,52.02614379084968,
4954,gene,2327487,2329413,-1,1926,ypvA,57.37279335410177,
4955,CDS,2327487,2329413,-1,1926,ypvA,57.37279335410177,
4956,gene,2329514,2329706,-1,192,yptA,57.8125,
4957,CDS,2329514,2329706,-1,192,yptA,57.8125,
4959,CDS,2329869,2330022,1,153,ypzG,58.82352941176471,
4958,gene,2329869,2330022,1,153,ypzG,58.82352941176471,
4960,gene,2330074,2331232,-1,1158,rlmKB,54.92227979274611,
4961,CDS,2330074,2331232,-1,1158,rlmKB,54.92227979274611,
4963,misc_RNA,2331319,2331720,-1,401,rnpB,51.3715710723192,
4962,gene,2331319,2331720,-1,401,rnpB,51.3715710723192,
4964,gene,2331778,2332075,-1,297,gpsB,65.31986531986533,
4965,CDS,2331778,2332075,-1,297,gpsB,65.31986531986533,
4966,gene,2332152,2332782,-1,630,ypsA,56.19047619047619,
4967,CDS,2332152,2332782,-1,630,ypsA,56.19047619047619,
4968,gene,2332783,2333011,-1,228,cotD,53.07017543859649,
4969,CDS,2332783,2333011,-1,228,cotD,53.07017543859649,
4970,gene,2333094,2333223,-1,129,BSU_22205,70.54263565891473,
4971,CDS,2333094,2333223,-1,129,BSU_22205,70.54263565891473,
4972,gene,2333323,2334565,-1,1242,yprB,55.394524959742355,
4973,CDS,2333323,2334565,-1,1242,yprB,55.394524959742355,
4974,gene,2334580,2336830,-1,2250,yprA,56.177777777777784,
4975,CDS,2334580,2336830,-1,2250,yprA,56.177777777777784,
4976,gene,2336932,2337439,-1,507,ypqE,55.818540433925044,
4977,CDS,2336932,2337439,-1,507,ypqE,55.818540433925044,
4979,CDS,2337576,2337996,1,420,ypqA,59.04761904761905,
4978,gene,2337576,2337996,1,420,ypqA,59.04761904761905,
4981,CDS,2338016,2338394,-1,378,yppG,57.936507936507944,
4980,gene,2338016,2338394,-1,378,yppG,57.936507936507944,
4982,gene,2338581,2338770,1,189,yppF,62.96296296296296,
4983,CDS,2338581,2338770,1,189,yppF,62.96296296296296,
4984,gene,2338808,2339180,-1,372,yppE,59.67741935483871,
4985,CDS,2338808,2339180,-1,372,yppE,59.67741935483871,
4987,CDS,2339225,2339471,-1,246,yppD,57.72357723577236,
4986,gene,2339225,2339471,-1,246,yppD,57.72357723577236,
4989,CDS,2339669,2339774,1,105,sspM,58.0952380952381,
4988,gene,2339669,2339774,1,105,sspM,58.0952380952381,
4990,gene,2339798,2340761,-1,963,yppC,58.67082035306335,
4991,CDS,2339798,2340761,-1,963,yppC,58.67082035306335,
4992,gene,2340801,2341422,1,621,recU,61.67471819645732,
4993,CDS,2340801,2341422,1,621,recU,61.67471819645732,
4995,CDS,2341443,2344188,1,2745,ponA,56.90346083788707,
4994,gene,2341443,2344188,1,2745,ponA,56.90346083788707,
4996,gene,2344263,2344758,-1,495,ypoC,56.96969696969697,
4997,CDS,2344263,2344758,-1,495,ypoC,56.96969696969697,
4999,CDS,2344754,2345414,-1,660,nth,54.54545454545454,
4998,gene,2344754,2345414,-1,660,nth,54.54545454545454,
5000,gene,2345432,2346131,-1,699,dnaD,60.37195994277539,
5001,CDS,2345432,2346131,-1,699,dnaD,60.37195994277539,
5002,gene,2346223,2347516,-1,1293,asnS,55.83913379737046,
5003,CDS,2346223,2347516,-1,1293,asnS,55.83913379737046,
5004,gene,2347659,2348841,-1,1182,aspB,55.922165820642974,
5005,CDS,2347659,2348841,-1,1182,aspB,55.922165820642974,
5007,CDS,2348863,2349349,-1,486,tseB,61.52263374485597,
5006,gene,2348863,2349349,-1,486,tseB,61.52263374485597,
5009,CDS,2349357,2349528,-1,171,ypmA,64.32748538011695,
5008,gene,2349357,2349528,-1,171,ypmA,64.32748538011695,
5010,gene,2349670,2352466,-1,2796,dinG,55.543633762517885,
5011,CDS,2349670,2352466,-1,2796,dinG,55.543633762517885,
5012,gene,2352591,2352975,-1,384,panD,57.8125,
5013,CDS,2352591,2352975,-1,384,panD,57.8125,
5015,CDS,2352976,2353837,-1,861,panC,56.329849012775846,
5014,gene,2352976,2353837,-1,861,panC,56.329849012775846,
5017,CDS,2353838,2354672,-1,834,panB,53.83693045563549,
5016,gene,2353838,2354672,-1,834,panB,53.83693045563549,
5018,gene,2354917,2355895,-1,978,birA,55.21472392638037,
5019,CDS,2354917,2355895,-1,978,birA,55.21472392638037,
5020,gene,2355879,2357073,-1,1194,cca,54.020100502512555,
5021,CDS,2355879,2357073,-1,1194,cca,54.020100502512555,
5022,gene,2357077,2358211,-1,1134,bshA,57.231040564373906,
5023,CDS,2357077,2358211,-1,1134,bshA,57.231040564373906,
5024,gene,2358207,2358918,-1,711,bshBA,55.27426160337553,
5025,CDS,2358207,2358918,-1,711,bshBA,55.27426160337553,
5026,gene,2358910,2359324,-1,414,mgsA,53.62318840579711,
5027,CDS,2358910,2359324,-1,414,mgsA,53.62318840579711,
5028,gene,2359339,2360143,-1,804,dapB,56.21890547263681,
5029,CDS,2359339,2360143,-1,804,dapB,56.21890547263681,
5031,CDS,2360154,2360490,-1,336,ypjD,58.63095238095239,
5030,gene,2360154,2360490,-1,336,ypjD,58.63095238095239,
5033,CDS,2360629,2361502,1,873,ypjC,57.273768613974795,
5032,gene,2360629,2361502,1,873,ypjC,57.273768613974795,
5034,gene,2361543,2362338,-1,795,ypjB,57.9874213836478,
5035,CDS,2361543,2362338,-1,795,ypjB,57.9874213836478,
5036,gene,2362406,2362964,-1,558,ypjA,56.451612903225815,
5037,CDS,2362406,2362964,-1,558,ypjA,56.451612903225815,
5038,gene,2363110,2363878,-1,768,qcrC,52.083333333333336,
5039,CDS,2363110,2363878,-1,768,qcrC,52.083333333333336,
5040,gene,2363912,2364587,-1,675,qcrB,53.629629629629626,
5041,CDS,2363912,2364587,-1,675,qcrB,53.629629629629626,
5042,gene,2364588,2365092,-1,504,qcrA,54.36507936507936,
5043,CDS,2364588,2365092,-1,504,qcrA,54.36507936507936,
5044,gene,2365234,2365681,-1,447,ypiF,61.07382550335571,
5045,CDS,2365234,2365681,-1,447,ypiF,61.07382550335571,
5047,CDS,2365735,2366275,-1,540,ypiB,60.55555555555555,
5046,gene,2365735,2366275,-1,540,ypiB,60.55555555555555,
5049,CDS,2366346,2367618,-1,1272,ypiA,58.17610062893082,
5048,gene,2366346,2367618,-1,1272,ypiA,58.17610062893082,
5050,gene,2367953,2369240,-1,1287,aroA,53.45765345765345,
5051,CDS,2367953,2369240,-1,1287,aroA,53.45765345765345,
5052,gene,2369250,2370366,-1,1116,tyrA,55.64516129032258,
5053,CDS,2369250,2370366,-1,1116,tyrA,55.64516129032258,
5055,CDS,2370414,2371497,-1,1083,hisC,54.84764542936288,
5054,gene,2370414,2371497,-1,1083,hisC,54.84764542936288,
5057,CDS,2371507,2372311,-1,804,trpA,55.223880597014926,
5056,gene,2371507,2372311,-1,804,trpA,55.223880597014926,
5058,gene,2372303,2373506,-1,1203,trpB,54.69659185369908,
5059,CDS,2372303,2373506,-1,1203,trpB,54.69659185369908,
5060,gene,2373486,2374134,-1,648,trpF,55.70987654320988,
5061,CDS,2373486,2374134,-1,648,trpF,55.70987654320988,
5062,gene,2374138,2374888,-1,750,trpC,57.733333333333334,
5063,misc_feature,2374138,2374888,-1,750,trpC,57.733333333333334,
5065,CDS,2374880,2375897,-1,1017,trpD,52.50737463126843,
5064,gene,2374880,2375897,-1,1017,trpD,52.50737463126843,
5067,CDS,2375868,2377416,-1,1548,trpE,57.041343669250644,
5066,gene,2375868,2377416,-1,1548,trpE,57.041343669250644,
5068,gene,2377631,2378015,-1,384,aroH,59.114583333333336,
5069,CDS,2377631,2378015,-1,384,aroH,59.114583333333336,
5070,gene,2378011,2379100,-1,1089,aroB,55.188246097337,
5071,CDS,2378011,2379100,-1,1089,aroB,55.188246097337,
5073,CDS,2379099,2380272,-1,1173,aroF,51.57715260017051,
5072,gene,2379099,2380272,-1,1173,aroF,51.57715260017051,
5075,CDS,2380346,2381117,-1,771,cheR,60.70038910505836,
5074,gene,2380346,2381117,-1,771,cheR,60.70038910505836,
5076,gene,2381353,2381803,-1,450,ndk,57.111111111111114,
5077,CDS,2381353,2381803,-1,450,ndk,57.111111111111114,
5078,gene,2381918,2382965,-1,1047,hepT,58.07067812798472,
5079,CDS,2381918,2382965,-1,1047,hepT,58.07067812798472,
5080,gene,2382906,2383608,-1,702,menG,54.55840455840456,
5081,CDS,2382906,2383608,-1,702,menG,54.55840455840456,
5083,CDS,2383614,2384370,-1,756,hepS,60.978835978835974,
5082,gene,2383614,2384370,-1,756,hepS,60.978835978835974,
5085,CDS,2384533,2384761,-1,228,mtrB,57.45614035087719,
5084,gene,2384533,2384761,-1,228,mtrB,57.45614035087719,
5086,gene,2384782,2385355,-1,573,folEA,54.275741710296685,
5087,CDS,2384782,2385355,-1,573,folEA,54.275741710296685,
5088,gene,2385542,2385821,-1,279,hbs,59.13978494623656,
5089,CDS,2385542,2385821,-1,279,hbs,59.13978494623656,
5090,gene,2386194,2387673,-1,1479,spoIVA,53.14401622718052,
5091,CDS,2386194,2387673,-1,1479,spoIVA,53.14401622718052,
5092,gene,2387853,2388588,-1,735,yphF,58.0952380952381,
5093,CDS,2387853,2388588,-1,735,yphF,58.0952380952381,
5094,gene,2388609,2388813,-1,204,yphE,59.80392156862745,
5095,CDS,2388609,2388813,-1,204,yphE,59.80392156862745,
5096,gene,2389150,2390188,-1,1038,gpsA,55.394990366088635,
5097,CDS,2389150,2390188,-1,1038,gpsA,55.394990366088635,
5098,gene,2390205,2391516,-1,1311,der,56.2929061784897,
5099,CDS,2390205,2391516,-1,1311,der,56.2929061784897,
5100,gene,2391669,2391864,-1,195,ypzH,59.48717948717949,
5101,CDS,2391669,2391864,-1,195,ypzH,59.48717948717949,
5102,gene,2391860,2392754,-1,894,yphB,56.82326621923938,
5103,CDS,2391860,2392754,-1,894,yphB,56.82326621923938,
5105,CDS,2392750,2393350,-1,600,yphA,60.0,
5104,gene,2392750,2393350,-1,600,yphA,60.0,
5106,gene,2393427,2393559,1,132,ypzI,57.57575757575758,
5107,CDS,2393427,2393559,1,132,ypzI,57.57575757575758,
5108,gene,2393601,2394651,-1,1050,fni,51.523809523809526,
5109,CDS,2393601,2394651,-1,1050,fni,51.523809523809526,
5110,gene,2394663,2395812,-1,1149,rpfA,57.96344647519582,
5111,CDS,2394663,2395812,-1,1149,rpfA,57.96344647519582,
5112,gene,2396044,2396719,-1,675,cmk,54.37037037037037,
5113,CDS,2396044,2396719,-1,675,cmk,54.37037037037037,
5114,gene,2396797,2396974,-1,177,ypfB,66.66666666666666,
5115,CDS,2396797,2396974,-1,177,ypfB,66.66666666666666,
5116,gene,2397018,2397672,-1,654,dgrA,58.71559633027523,
5117,CDS,2397018,2397672,-1,654,dgrA,58.71559633027523,
5119,CDS,2397764,2399117,-1,1353,sleC,60.236511456023656,
5118,gene,2397764,2399117,-1,1353,sleC,60.236511456023656,
5121,CDS,2399151,2400069,-1,918,sleB,54.79302832244009,
5120,gene,2399151,2400069,-1,918,sleB,54.79302832244009,
5122,gene,2400207,2400864,-1,657,prsW,59.3607305936073,
5123,CDS,2400207,2400864,-1,657,prsW,59.3607305936073,
5124,gene,2400983,2401958,-1,975,ypdA,58.35897435897436,
5125,CDS,2400983,2401958,-1,975,ypdA,58.35897435897436,
5127,CDS,2402066,2403350,-1,1284,gudB,55.52959501557633,
5126,gene,2402066,2403350,-1,1284,gudB,55.52959501557633,
5129,CDS,2403505,2404090,-1,585,mecB,57.77777777777777,
5128,gene,2403505,2404090,-1,585,mecB,57.77777777777777,
5130,gene,2404248,2405028,-1,780,ypbG,54.74358974358975,
5131,CDS,2404248,2405028,-1,780,ypbG,54.74358974358975,
5132,gene,2405113,2405557,-1,444,ypbF,60.810810810810814,
5133,CDS,2405113,2405557,-1,444,ypbF,60.810810810810814,
5134,gene,2405619,2406342,-1,723,ypbE,58.36791147994468,
5135,CDS,2405619,2406342,-1,723,ypbE,58.36791147994468,putative enzyme possibly involved in cell wall turnover
5137,CDS,2406292,2406862,-1,570,ypbD,58.59649122807018,
5136,gene,2406292,2406862,-1,570,ypbD,58.59649122807018,
5139,CDS,2406921,2408412,-1,1491,recS,54.258886653252844,
5138,gene,2406921,2408412,-1,1491,recS,54.258886653252844,
5140,gene,2408404,2409463,-1,1059,gmmB,54.95750708215298,
5141,CDS,2408404,2409463,-1,1059,gmmB,54.95750708215298,
5142,gene,2409728,2409977,1,249,fer,54.61847389558233,
5143,CDS,2409728,2409977,1,249,fer,54.61847389558233,
5145,CDS,2410016,2410589,-1,573,fmnP,59.33682373472949,
5144,gene,2410016,2410589,-1,573,fmnP,59.33682373472949,
5147,misc_RNA,2410580,2410888,-1,308,fswB,56.493506493506494,
5146,gene,2410580,2410888,-1,308,fswB,56.493506493506494,
5148,gene,2411085,2412663,1,1578,serA,57.22433460076045,
5149,CDS,2411085,2412663,1,1578,serA,57.22433460076045,
5150,gene,2412705,2413473,-1,768,aroC,57.161458333333336,
5151,CDS,2412705,2413473,-1,768,aroC,57.161458333333336,
5152,gene,2413584,2414691,-1,1107,rsiX,59.168925022583565,
5153,CDS,2413584,2414691,-1,1107,rsiX,59.168925022583565,
5155,CDS,2414626,2415211,-1,585,sigX,59.82905982905983,
5154,gene,2414626,2415211,-1,585,sigX,59.82905982905983,
5157,CDS,2415414,2417184,-1,1770,resE,56.89265536723164,
5156,gene,2415414,2417184,-1,1770,resE,56.89265536723164,
5158,gene,2417180,2417903,-1,723,resD,56.293222683264176,
5159,CDS,2417180,2417903,-1,723,resD,56.293222683264176,
5160,gene,2417983,2419159,-1,1176,resC,53.57142857142857,
5161,CDS,2417983,2419159,-1,1176,resC,53.57142857142857,
5162,gene,2419178,2420807,-1,1629,resB,55.80110497237569,
5163,CDS,2419178,2420807,-1,1629,resB,55.80110497237569,
5164,gene,2420803,2421343,-1,540,resA,57.407407407407405,
5165,CDS,2420803,2421343,-1,540,resA,57.407407407407405,
5166,gene,2421437,2422172,-1,735,rluB,52.925170068027214,
5167,CDS,2421437,2422172,-1,735,rluB,52.925170068027214,
5168,gene,2422263,2422800,-1,537,spmB,54.56238361266295,
5169,CDS,2422263,2422800,-1,537,spmB,54.56238361266295,
5170,gene,2422804,2423395,-1,591,spmA,54.653130287648054,
5171,CDS,2422804,2423395,-1,591,spmA,54.653130287648054,
5173,CDS,2423382,2424531,-1,1149,dacB,58.7467362924282,
5172,gene,2423382,2424531,-1,1149,dacB,58.7467362924282,
5175,CDS,2424653,2425193,-1,540,ypuI,54.44444444444444,
5174,gene,2424653,2425193,-1,540,ypuI,54.44444444444444,
5176,gene,2425247,2425841,-1,594,spcB,55.218855218855225,
5177,CDS,2425247,2425841,-1,594,spcB,55.218855218855225,
5178,gene,2425830,2426586,-1,756,scpA,59.65608465608465,
5179,CDS,2425830,2426586,-1,756,scpA,59.65608465608465,
5181,CDS,2426866,2427391,1,525,ypuF,56.38095238095238,
5180,gene,2426866,2427391,1,525,ypuF,56.38095238095238,
5183,CDS,2427404,2427779,-1,375,ypzK,59.73333333333334,
5182,gene,2427404,2427779,-1,375,ypzK,59.73333333333334,
5184,gene,2427891,2428356,-1,465,ribH,57.41935483870968,
5185,CDS,2427891,2428356,-1,465,ribH,57.41935483870968,
5186,gene,2428388,2429585,-1,1197,ribBA,53.88471177944862,
5187,CDS,2428388,2429585,-1,1197,ribBA,53.88471177944862,
5189,CDS,2429599,2430247,-1,648,ribE,59.876543209876544,
5188,gene,2429599,2430247,-1,648,ribE,59.876543209876544,
5190,gene,2430257,2431343,-1,1086,ribD,52.20994475138122,
5191,CDS,2430257,2431343,-1,1086,ribD,52.20994475138122,
5193,misc_RNA,2431472,2431617,-1,145,fswA,46.89655172413793,
5192,gene,2431472,2431617,-1,145,fswA,46.89655172413793,
5194,gene,2431736,2432081,-1,345,ypuD,62.89855072463768,
5195,CDS,2431736,2432081,-1,345,ypuD,62.89855072463768,
5196,gene,2432315,2432870,-1,555,sipS,58.01801801801801,
5197,CDS,2432315,2432870,-1,555,sipS,58.01801801801801,
5198,gene,2433136,2433373,1,237,ypzC,62.447257383966246,
5199,CDS,2433136,2433373,1,237,ypzC,62.447257383966246,
5201,CDS,2433315,2433522,-1,207,ypzJ,60.86956521739131,
5200,gene,2433315,2433522,-1,207,ypzJ,60.86956521739131,
5203,misc_feature,2433630,2433885,-1,255,ypuC,57.647058823529406,
5202,gene,2433630,2433885,-1,255,ypuC,57.647058823529406,
5204,gene,2433877,2434165,-1,288,ypuC,56.59722222222222,
5205,misc_feature,2433877,2434165,-1,288,ypuC,56.59722222222222,
5206,gene,2434142,2434346,-1,204,ypuB,51.9607843137255,
5207,CDS,2434142,2434346,-1,204,ypuB,51.9607843137255,
5209,misc_feature,2434754,2434871,1,117,BSU_23349,58.119658119658126,
5208,gene,2434754,2434871,1,117,BSU_23349,58.119658119658126,
5211,CDS,2435011,2435224,1,213,ypzD,66.19718309859155,
5210,gene,2435011,2435224,1,213,ypzD,66.19718309859155,
5212,gene,2435359,2435791,-1,432,ppiB,53.70370370370371,
5213,CDS,2435359,2435791,-1,432,ppiB,53.70370370370371,
5214,gene,2436044,2436917,1,873,ypuA,57.388316151202744,
5215,CDS,2436044,2436917,1,873,ypuA,57.388316151202744,
5216,gene,2436946,2438266,-1,1320,lysA,54.24242424242425,
5217,CDS,2436946,2438266,-1,1320,lysA,54.24242424242425,
5218,gene,2438371,2439853,-1,1482,spoVAF,55.26315789473685,
5219,CDS,2438371,2439853,-1,1482,spoVAF,55.26315789473685,
5220,gene,2439803,2440415,-1,612,spoVAEA,51.143790849673195,
5221,CDS,2439803,2440415,-1,612,spoVAEA,51.143790849673195,
5222,gene,2440422,2440773,-1,351,spoVAEB,52.42165242165242,
5223,CDS,2440422,2440773,-1,351,spoVAEB,52.42165242165242,
5225,CDS,2440774,2441791,-1,1017,spoVAD,52.50737463126843,
5224,gene,2440774,2441791,-1,1017,spoVAD,52.50737463126843,
5227,CDS,2441803,2442256,-1,453,spoVAC,58.94039735099338,
5226,gene,2441803,2442256,-1,453,spoVAC,58.94039735099338,
5228,gene,2442268,2442694,-1,426,spoVAB,53.52112676056338,
5229,CDS,2442268,2442694,-1,426,spoVAB,53.52112676056338,
5230,gene,2442683,2443304,-1,621,spoVAA,57.648953301127214,
5231,CDS,2442683,2443304,-1,621,spoVAA,57.648953301127214,
5233,CDS,2443428,2444196,-1,768,sigF,55.208333333333336,
5232,gene,2443428,2444196,-1,768,sigF,55.208333333333336,
5235,CDS,2444207,2444648,-1,441,spoIIAB,57.82312925170068,
5234,gene,2444207,2444648,-1,441,spoIIAB,57.82312925170068,
5236,gene,2444644,2444998,-1,354,spoIIAA,55.932203389830505,
5237,CDS,2444644,2444998,-1,354,spoIIAA,55.932203389830505,
5238,gene,2445093,2446263,-1,1170,dacF,58.80341880341881,
5239,CDS,2445093,2446263,-1,1170,dacF,58.80341880341881,
5240,gene,2446417,2447233,-1,816,pupG,53.431372549019606,
5241,CDS,2446417,2447233,-1,816,pupG,53.431372549019606,
5243,CDS,2447245,2448430,-1,1185,deoB,53.502109704641356,
5242,gene,2447245,2448430,-1,1185,deoB,53.502109704641356,
5245,CDS,2448590,2449481,-1,891,ripX,54.54545454545454,
5244,gene,2448590,2449481,-1,891,ripX,54.54545454545454,
5247,CDS,2449488,2449716,-1,228,yqzK,59.210526315789465,
5246,gene,2449488,2449716,-1,228,yqzK,59.210526315789465,
5248,gene,2449840,2450290,-1,450,fur,57.99999999999999,
5249,CDS,2449840,2450290,-1,450,fur,57.99999999999999,
5250,gene,2450402,2451047,-1,645,spoIIM,59.379844961240316,
5251,CDS,2450402,2451047,-1,645,spoIIM,59.379844961240316,autolysin component for dissolution of the septal cell wall (stage II sporulation)
5252,gene,2451147,2451363,-1,216,yqkK,57.870370370370374,
5253,CDS,2451147,2451363,-1,216,yqkK,57.870370370370374,
5255,CDS,2451462,2452782,-1,1320,mleA,50.227272727272734,
5254,gene,2451462,2452782,-1,1320,mleA,50.227272727272734,
5256,gene,2452799,2454206,-1,1407,mleN,58.9907604832978,
5257,CDS,2452799,2454206,-1,1407,mleN,58.9907604832978,
5258,gene,2454346,2455774,-1,1428,ansB,54.13165266106442,
5259,CDS,2454346,2455774,-1,1428,ansB,54.13165266106442,
5260,gene,2455818,2456808,-1,990,ansA,56.36363636363636,
5261,CDS,2455818,2456808,-1,990,ansA,56.36363636363636,
5262,gene,2456989,2457340,1,351,ansR,53.84615384615385,
5263,CDS,2456989,2457340,1,351,ansR,53.84615384615385,
5264,gene,2457348,2458512,-1,1164,yqxK,53.78006872852234,
5265,CDS,2457348,2458512,-1,1164,yqxK,53.78006872852234,
5266,gene,2458508,2459066,-1,558,nudF,56.272401433691755,
5267,CDS,2458508,2459066,-1,558,nudF,56.272401433691755,
5268,gene,2459140,2459263,1,123,mciZ,58.536585365853654,
5269,CDS,2459140,2459263,1,123,mciZ,58.536585365853654,
5271,CDS,2459325,2460246,1,921,yqkF,54.72312703583062,
5270,gene,2459325,2460246,1,921,yqkF,54.72312703583062,
5272,gene,2460277,2460502,-1,225,yqkE,65.77777777777779,
5273,CDS,2460277,2460502,-1,225,yqkE,65.77777777777779,
5274,gene,2460663,2461581,1,918,yqkD,54.68409586056645,
5275,CDS,2460663,2461581,1,918,yqkD,54.68409586056645,
5276,gene,2461620,2461860,-1,240,yqkC,57.08333333333333,
5277,CDS,2461620,2461860,-1,240,yqkC,57.08333333333333,
5278,gene,2461872,2462196,-1,324,yqkB,50.92592592592593,
5279,CDS,2461872,2462196,-1,324,yqkB,50.92592592592593,
5280,gene,2462192,2463224,-1,1032,yqkA,56.104651162790695,
5281,CDS,2462192,2463224,-1,1032,yqkA,56.104651162790695,
5282,gene,2463216,2463561,-1,345,yqjZ,53.62318840579711,
5283,CDS,2463216,2463561,-1,345,yqjZ,53.62318840579711,
5284,gene,2463570,2464041,-1,471,yqjY,59.23566878980891,
5285,CDS,2463570,2464041,-1,471,yqjY,59.23566878980891,
5286,gene,2464226,2464565,-1,339,yqjX,53.09734513274337,
5287,CDS,2464226,2464565,-1,339,yqjX,53.09734513274337,
5288,gene,2464561,2465800,-1,1239,polYB,49.717514124293785,
5289,CDS,2464561,2465800,-1,1239,polYB,49.717514124293785,
5290,gene,2465965,2466172,1,207,yqzH,57.48792270531401,
5291,CDS,2465965,2466172,1,207,yqzH,57.48792270531401,
5292,gene,2466720,2467953,1,1233,yqjV,53.933495539334956,
5293,CDS,2466720,2467953,1,1233,yqjV,53.933495539334956,
5294,gene,2467799,2468162,1,363,yqjU,55.09641873278237,
5295,CDS,2467799,2468162,1,363,yqjU,55.09641873278237,
5296,gene,2468158,2468545,-1,387,yqjT,53.746770025839794,
5297,CDS,2468158,2468545,-1,387,yqjT,53.746770025839794,
5298,gene,2468548,2469508,-1,960,coaA,56.56250000000001,
5299,CDS,2468548,2469508,-1,960,coaA,56.56250000000001,
5300,gene,2469579,2470926,-1,1347,dsdA,52.26429101707498,
5301,CDS,2469579,2470926,-1,1347,dsdA,52.26429101707498,
5302,gene,2471001,2471781,-1,780,yqjQ,51.41025641025641,
5303,CDS,2471001,2471781,-1,780,yqjQ,51.41025641025641,
5304,gene,2471786,2472746,-1,960,yqjP,53.125,
5305,CDS,2471786,2472746,-1,960,yqjP,53.125,
5306,gene,2472879,2473125,1,246,pswI,51.6260162601626,
5307,misc_RNA,2472879,2473125,1,246,pswI,51.6260162601626,
5308,gene,2473150,2473987,1,837,proI,53.40501792114696,
5309,CDS,2473150,2473987,1,837,proI,53.40501792114696,
5310,gene,2474027,2475671,-1,1644,yqjN,54.62287104622872,
5311,CDS,2474027,2475671,-1,1644,yqjN,54.62287104622872,
5312,gene,2475842,2476859,1,1017,yqjM,53.785644051130774,
5313,CDS,2475842,2476859,1,1017,yqjM,53.785644051130774,
5314,gene,2476968,2477730,1,762,yqjL,54.7244094488189,
5315,CDS,2476968,2477730,1,762,yqjL,54.7244094488189,
5316,gene,2477776,2477899,-1,123,rpmGCc,60.97560975609756,
5317,misc_feature,2477776,2477899,-1,123,rpmGCc,60.97560975609756,
5318,gene,2477891,2477924,-1,33,rpmGCn,66.66666666666666,
5319,misc_feature,2477891,2477924,-1,33,rpmGCn,66.66666666666666,
5320,gene,2478005,2478929,-1,924,rnz,53.896103896103895,
5321,CDS,2478005,2478929,-1,924,rnz,53.896103896103895,
5322,gene,2479155,2480625,1,1470,zwf,57.48299319727891,
5323,CDS,2479155,2480625,1,1470,zwf,57.48299319727891,
5324,gene,2480749,2482159,-1,1410,gndA,56.02836879432624,
5325,CDS,2480749,2482159,-1,1410,gndA,56.02836879432624,
5326,gene,2482268,2483513,-1,1245,polYA,53.81526104417671,
5327,CDS,2482268,2483513,-1,1245,polYA,53.81526104417671,
5328,gene,2483585,2483873,1,288,mifM,59.72222222222222,
5329,CDS,2483585,2483873,1,288,mifM,59.72222222222222,
5330,gene,2483903,2484731,1,828,oxaAB,56.52173913043478,
5331,CDS,2483903,2484731,1,828,oxaAB,56.52173913043478,
5333,CDS,2484910,2485639,1,729,yqjF,53.90946502057613,
5332,gene,2484910,2485639,1,729,yqjF,53.90946502057613,
5335,CDS,2485679,2486795,-1,1116,yqjE,53.76344086021505,
5334,gene,2485679,2486795,-1,1116,yqjE,53.76344086021505,
5336,gene,2486812,2488336,-1,1524,yqjD,51.115485564304464,
5337,CDS,2486812,2488336,-1,1524,yqjD,51.115485564304464,
5338,gene,2488328,2488751,-1,423,yqjC,56.73758865248227,
5339,CDS,2488328,2488751,-1,423,yqjC,56.73758865248227,
5341,CDS,2488952,2489483,-1,531,yqjB,56.12052730696798,
5340,gene,2488952,2489483,-1,531,yqjB,56.12052730696798,
5343,CDS,2489534,2490503,-1,969,yqjA,58.7203302373581,
5342,gene,2489534,2490503,-1,969,yqjA,58.7203302373581,
5344,gene,2490573,2491296,-1,723,artR,55.18672199170125,
5345,CDS,2490573,2491296,-1,723,artR,55.18672199170125,
5346,gene,2491288,2491948,-1,660,artQ,57.12121212121212,
5347,CDS,2491288,2491948,-1,660,artQ,57.12121212121212,
5348,gene,2492028,2492796,-1,768,artP,58.59375,
5349,CDS,2492028,2492796,-1,768,artP,58.59375,
5350,gene,2493063,2493501,-1,438,brxB,54.109589041095894,
5351,CDS,2493063,2493501,-1,438,brxB,54.109589041095894,
5353,CDS,2493661,2494555,1,894,bmrU,55.033557046979865,
5352,gene,2493661,2494555,1,894,bmrU,55.033557046979865,
5354,gene,2494655,2495825,1,1170,bmr,55.47008547008547,
5355,CDS,2494655,2495825,1,1170,bmr,55.47008547008547,
5356,gene,2495897,2496734,1,837,bmrR,59.976105137395464,
5357,CDS,2495897,2496734,1,837,bmrR,59.976105137395464,
5359,CDS,2496795,2498070,-1,1275,bkdB,53.88235294117647,
5358,gene,2496795,2498070,-1,1275,bkdB,53.88235294117647,
5360,gene,2498092,2499076,-1,984,bkdAB,51.52439024390244,
5361,CDS,2498092,2499076,-1,984,bkdAB,51.52439024390244,
5363,CDS,2499089,2500082,-1,993,bkdAA,52.26586102719033,
5362,gene,2499089,2500082,-1,993,bkdAA,52.26586102719033,
5364,gene,2500103,2501528,-1,1425,lpdV,51.92982456140351,
5365,CDS,2500103,2501528,-1,1425,lpdV,51.92982456140351,
5366,gene,2501548,2502640,-1,1092,buk,54.395604395604394,
5367,CDS,2501548,2502640,-1,1092,buk,54.395604395604394,
5369,CDS,2502658,2503753,-1,1095,bcd,52.694063926940636,
5368,gene,2502658,2503753,-1,1095,bcd,52.694063926940636,
5371,CDS,2503764,2504664,-1,900,ptb,51.888888888888886,
5370,gene,2503764,2504664,-1,900,ptb,51.888888888888886,
5372,gene,2504788,2506867,-1,2079,bkdR,54.83405483405483,
5373,CDS,2504788,2506867,-1,2079,bkdR,54.83405483405483,
5374,gene,2507019,2507256,1,237,yqzF,55.27426160337553,
5375,CDS,2507019,2507256,1,237,yqzF,55.27426160337553,
5376,gene,2507297,2508203,-1,906,mmgF,50.22075055187638,
5377,CDS,2507297,2508203,-1,906,mmgF,50.22075055187638,
5378,gene,2508220,2509639,-1,1419,mmgE,52.572233967582804,
5379,CDS,2508220,2509639,-1,1419,mmgE,52.572233967582804,
5380,gene,2509653,2510772,-1,1119,mmgD,52.63628239499554,
5381,CDS,2509653,2510772,-1,1119,mmgD,52.63628239499554,
5382,gene,2510805,2511945,-1,1140,mmgC,52.63157894736842,
5383,CDS,2510805,2511945,-1,1140,mmgC,52.63157894736842,
5384,gene,2511972,2512836,-1,864,mmgB,51.736111111111114,
5385,CDS,2511972,2512836,-1,864,mmgB,51.736111111111114,
5386,gene,2512860,2514042,-1,1182,mmgA,48.223350253807105,
5387,CDS,2512860,2514042,-1,1182,mmgA,48.223350253807105,
5389,CDS,2514168,2514900,-1,732,glpQ,53.68852459016394,
5388,gene,2514168,2514900,-1,732,glpQ,53.68852459016394,
5390,gene,2514978,2515599,-1,621,yqiI,51.85185185185185,
5391,CDS,2514978,2515599,-1,621,yqiI,51.85185185185185,
5392,gene,2515613,2515907,-1,294,yqiH,55.78231292517006,
5393,CDS,2515613,2515907,-1,294,yqiH,55.78231292517006,
5394,gene,2516214,2516367,1,153,BSU_24205,51.633986928104584,
5395,CDS,2516214,2516367,1,153,BSU_24205,51.633986928104584,
5396,gene,2516439,2517558,1,1119,yqiG,52.36818588025023,
5397,CDS,2516439,2517558,1,1119,yqiG,52.36818588025023,
5399,CDS,2518022,2518826,-1,804,spo0A,54.975124378109456,
5398,gene,2518022,2518826,-1,804,spo0A,54.975124378109456,
5400,gene,2519101,2520382,-1,1281,spoIVB,59.250585480093676,
5401,CDS,2519101,2520382,-1,1281,spoIVB,59.250585480093676,
5402,gene,2520556,2522287,-1,1731,recN,54.24610051993067,
5403,CDS,2520556,2522287,-1,1731,recN,54.24610051993067,
5405,CDS,2522323,2522773,-1,450,argR,55.55555555555556,
5404,gene,2522323,2522773,-1,450,argR,55.55555555555556,
5407,CDS,2522870,2523716,-1,846,yqxC,52.836879432624116,
5406,gene,2522870,2523716,-1,846,yqxC,52.836879432624116,
5408,gene,2523712,2525614,-1,1902,dxs,52.26077812828601,
5409,CDS,2523712,2525614,-1,1902,dxs,52.26077812828601,
5410,gene,2525788,2526679,-1,891,ispA,53.98428731762065,
5411,CDS,2525788,2526679,-1,891,ispA,53.98428731762065,
5413,CDS,2526668,2526923,-1,255,xseB,59.21568627450981,
5412,gene,2526668,2526923,-1,255,xseB,59.21568627450981,
5414,gene,2526919,2528266,-1,1347,xseA,55.75352635486266,
5415,CDS,2526919,2528266,-1,1347,xseA,55.75352635486266,
5416,gene,2528403,2529255,-1,852,folD,54.460093896713616,
5417,CDS,2528403,2529255,-1,852,folD,54.460093896713616,
5418,gene,2529266,2529662,-1,396,nusB,57.32323232323232,
5419,CDS,2529266,2529662,-1,396,nusB,57.32323232323232,
5421,CDS,2529925,2530333,-1,408,yqhY,55.63725490196079,
5420,gene,2529925,2530333,-1,408,yqhY,55.63725490196079,
5423,CDS,2530353,2531706,-1,1353,accC,54.69327420546932,
5422,gene,2530353,2531706,-1,1353,accC,54.69327420546932,
5425,CDS,2531717,2532197,-1,480,accB,55.625,
5424,gene,2531717,2532197,-1,480,accB,55.625,
5426,gene,2532352,2533009,-1,657,spoIIIAH,57.8386605783866,
5427,CDS,2532352,2533009,-1,657,spoIIIAH,57.8386605783866,
5428,gene,2533009,2533699,-1,690,spoIIIAG,59.130434782608695,
5429,CDS,2533009,2533699,-1,690,spoIIIAG,59.130434782608695,
5430,gene,2533691,2534312,-1,621,spoIIIAF,57.648953301127214,
5431,CDS,2533691,2534312,-1,621,spoIIIAF,57.648953301127214,
5432,gene,2534325,2535525,-1,1200,spoIIIAE,53.75,
5433,CDS,2534325,2535525,-1,1200,spoIIIAE,53.75,
5434,gene,2535543,2535945,-1,402,spoIIIAD,61.940298507462686,
5435,CDS,2535543,2535945,-1,402,spoIIIAD,61.940298507462686,
5436,gene,2535951,2536158,-1,207,spoIIIAC,61.35265700483091,
5437,CDS,2535951,2536158,-1,207,spoIIIAC,61.35265700483091,
5438,gene,2536180,2536696,-1,516,spoIIIAB,51.162790697674424,
5439,CDS,2536180,2536696,-1,516,spoIIIAB,51.162790697674424,
5441,CDS,2536689,2537613,-1,924,spoIIIAA,50.10822510822511,
5440,gene,2536689,2537613,-1,924,spoIIIAA,50.10822510822511,
5443,CDS,2537688,2537970,-1,282,yqhV,59.21985815602837,
5442,gene,2537688,2537970,-1,282,yqhV,59.21985815602837,
5444,gene,2538114,2538672,-1,558,efp,56.81003584229391,
5445,CDS,2538114,2538672,-1,558,efp,56.81003584229391,
5446,gene,2538696,2539758,-1,1062,papA,53.01318267419962,
5447,CDS,2538696,2539758,-1,1062,papA,53.01318267419962,
5448,gene,2539754,2540201,-1,447,yqhS,52.348993288590606,
5449,CDS,2539754,2540201,-1,447,yqhS,52.348993288590606,
5450,gene,2540287,2540824,-1,537,yqhR,58.84543761638734,
5451,CDS,2540287,2540824,-1,537,yqhR,58.84543761638734,
5452,gene,2541050,2542007,1,957,yqhQ,56.53082549634274,
5453,CDS,2541050,2542007,1,957,yqhQ,56.53082549634274,
5454,gene,2542046,2542442,1,396,yqhP,55.3030303030303,
5455,CDS,2542046,2542442,1,396,yqhP,55.3030303030303,
5457,CDS,2542438,2543314,-1,876,yqhO,53.31050228310502,
5456,gene,2542438,2543314,-1,876,yqhO,53.31050228310502,
5459,CDS,2543439,2543868,-1,429,mntR,64.80186480186481,
5458,gene,2543439,2543868,-1,429,mntR,64.80186480186481,
5461,CDS,2543967,2544804,-1,837,lipM,55.91397849462365,
5460,gene,2543967,2544804,-1,837,lipM,55.91397849462365,
5462,gene,2544994,2545375,1,381,yqhL,55.38057742782152,
5463,CDS,2544994,2545375,1,381,yqhL,55.38057742782152,
5464,gene,2545409,2546876,-1,1467,gcvPB,52.07907293796864,
5465,CDS,2545409,2546876,-1,1467,gcvPB,52.07907293796864,
5466,gene,2546868,2548215,-1,1347,gcvPA,53.60059391239792,
5467,CDS,2546868,2548215,-1,1347,gcvPA,53.60059391239792,
5468,gene,2548244,2549333,-1,1089,gcvT,55.28007346189165,
5469,CDS,2548244,2549333,-1,1089,gcvT,55.28007346189165,
5470,gene,2549406,2549606,-1,200,swgA,47.5,
5471,misc_RNA,2549406,2549606,-1,200,swgA,47.5,
5473,CDS,2549774,2551448,1,1674,yqhH,58.841099163679814,
5472,gene,2549774,2551448,1,1674,yqhH,58.841099163679814,
5474,gene,2551468,2552263,1,795,yqhG,59.874213836477985,
5475,CDS,2551468,2552263,1,795,yqhG,59.874213836477985,
5476,gene,2552445,2552619,1,174,sinI,60.91954022988506,
5477,CDS,2552445,2552619,1,174,sinI,60.91954022988506,
5479,CDS,2552652,2552988,1,336,sinR,60.416666666666664,
5478,gene,2552652,2552988,1,336,sinR,60.416666666666664,
5481,CDS,2553080,2553866,-1,786,tasA,62.34096692111959,
5480,gene,2553080,2553866,-1,786,tasA,62.34096692111959,
5482,gene,2553929,2554502,-1,573,sipW,57.59162303664922,
5483,CDS,2553929,2554502,-1,573,sipW,57.59162303664922,
5484,gene,2554485,2555247,-1,762,tapA,60.76115485564304,
5485,CDS,2554485,2555247,-1,762,tapA,60.76115485564304,
5487,CDS,2555518,2555845,1,327,yqzG,59.32721712538226,
5486,gene,2555518,2555845,1,327,yqzG,59.32721712538226,
5488,gene,2555886,2556066,-1,180,spoIIT,61.111111111111114,
5489,CDS,2555886,2556066,-1,180,spoIIT,61.111111111111114,
5491,CDS,2556136,2556511,-1,375,comGG,60.8,
5490,gene,2556136,2556511,-1,375,comGG,60.8,
5492,gene,2556511,2556895,-1,384,comGF,59.114583333333336,
5493,CDS,2556511,2556895,-1,384,comGF,59.114583333333336,
5495,CDS,2556920,2557268,-1,348,comGE,58.04597701149425,
5494,gene,2556920,2557268,-1,348,comGE,58.04597701149425,
5497,CDS,2557251,2557683,-1,432,comGD,59.02777777777778,
5496,gene,2557251,2557683,-1,432,comGD,59.02777777777778,
5499,CDS,2557672,2557969,-1,297,comGC,61.27946127946128,
5498,gene,2557672,2557969,-1,297,comGC,61.27946127946128,
5500,gene,2557982,2558954,-1,972,comGB,58.333333333333336,
5501,CDS,2557982,2558954,-1,972,comGB,58.333333333333336,
5502,gene,2559006,2560077,-1,1071,comGA,58.07656395891691,
5503,CDS,2559006,2560077,-1,1071,comGA,58.07656395891691,
5504,gene,2560488,2561442,-1,954,yqxL,60.691823899371066,
5505,CDS,2560488,2561442,-1,954,yqxL,60.691823899371066,
5507,CDS,2561584,2562913,1,1329,yqhB,59.14221218961625,
5506,gene,2561584,2562913,1,1329,yqhB,59.14221218961625,
5509,CDS,2562965,2563802,-1,837,rsbRD,58.183990442054956,
5508,gene,2562965,2563802,-1,837,rsbRD,58.183990442054956,
5510,gene,2563888,2563959,1,71,trnSL-Gln1,46.478873239436616,
5511,tRNA,2563888,2563959,1,71,trnSL-Gln1,46.478873239436616,
5512,gene,2564025,2564406,-1,381,mgsR,62.72965879265092,
5513,CDS,2564025,2564406,-1,381,mgsR,62.72965879265092,
5515,CDS,2564637,2564883,1,246,yqgY,63.41463414634146,
5514,gene,2564637,2564883,1,246,yqgY,63.41463414634146,
5516,gene,2564922,2565558,-1,636,yqgX,54.55974842767296,
5517,CDS,2564922,2565558,-1,636,yqgX,54.55974842767296,
5518,gene,2565714,2565888,1,174,yqgW,58.04597701149425,
5519,CDS,2565714,2565888,1,174,yqgW,58.04597701149425,
5520,gene,2565919,2566234,-1,315,yqgV,57.460317460317455,
5521,CDS,2565919,2566234,-1,315,yqgV,57.460317460317455,
5522,gene,2566236,2567298,-1,1062,yqgU,58.568738229755176,
5523,CDS,2566236,2567298,-1,1062,yqgU,58.568738229755176,
5524,gene,2567359,2568490,-1,1131,yqgT,56.94076038903625,
5525,CDS,2567359,2568490,-1,1131,yqgT,56.94076038903625,
5527,CDS,2568572,2570489,-1,1917,ltaSC,59.72874282733438,
5526,gene,2568572,2570489,-1,1917,ltaSC,59.72874282733438,
5528,gene,2570605,2571571,-1,966,glcK,52.69151138716356,
5529,CDS,2570605,2571571,-1,966,glcK,52.69151138716356,
5531,CDS,2571581,2571797,-1,216,yqgQ,62.96296296296296,
5530,gene,2571581,2571797,-1,216,yqgQ,62.96296296296296,
5532,gene,2571906,2573430,-1,1524,glpG,55.052493438320205,
5533,CDS,2571906,2573430,-1,1524,glpG,55.052493438320205,
5534,gene,2573519,2573693,-1,174,yqgO,63.793103448275865,
5535,CDS,2573519,2573693,-1,174,yqgO,63.793103448275865,
5536,gene,2573759,2574323,-1,564,folN,56.02836879432624,
5537,CDS,2573759,2574323,-1,564,folN,56.02836879432624,
5538,gene,2574407,2574557,-1,150,rpmGA,64.66666666666666,
5539,CDS,2574407,2574557,-1,150,rpmGA,64.66666666666666,
5540,gene,2574640,2575720,-1,1080,yqgM,53.61111111111111,
5541,CDS,2574640,2575720,-1,1080,yqgM,53.61111111111111,
5543,CDS,2575716,2576187,-1,471,yqgL,57.74946921443737,
5542,gene,2575716,2576187,-1,471,yqgL,57.74946921443737,
5544,gene,2576366,2576720,1,354,yqzD,62.42937853107344,
5545,CDS,2576366,2576720,1,354,yqzD,62.42937853107344,
5547,CDS,2576716,2577181,1,465,yqzC,59.78494623655914,
5546,gene,2576716,2577181,1,465,yqzC,59.78494623655914,
5548,gene,2577209,2577992,-1,783,pstBB,58.23754789272031,
5549,CDS,2577209,2577992,-1,783,pstBB,58.23754789272031,
5551,CDS,2578002,2578812,-1,810,pstBA,58.395061728395056,
5550,gene,2578002,2578812,-1,810,pstBA,58.395061728395056,
5552,gene,2578832,2579717,-1,885,pstA,55.367231638418076,
5553,CDS,2578832,2579717,-1,885,pstA,55.367231638418076,
5555,CDS,2579716,2580646,-1,930,pstC,54.086021505376344,
5554,gene,2579716,2580646,-1,930,pstC,54.086021505376344,
5556,gene,2580714,2581617,-1,903,pstS,57.696566998892585,
5557,CDS,2580714,2581617,-1,903,pstS,57.696566998892585,
5558,gene,2581770,2583921,-1,2151,pbpA,60.111576011157595,
5559,CDS,2581770,2583921,-1,2151,pbpA,60.111576011157595,
5561,CDS,2584034,2585327,-1,1293,yqgE,57.61794276875484,
5560,gene,2584034,2585327,-1,1293,yqgE,57.61794276875484,
5562,gene,2585433,2586042,-1,609,sodA,54.35139573070607,
5563,CDS,2585433,2586042,-1,609,sodA,54.35139573070607,
5565,CDS,2586220,2586703,-1,483,yqgC,57.34989648033127,
5564,gene,2586220,2586703,-1,483,yqgC,57.34989648033127,
5566,gene,2586812,2587580,1,768,yqgB,62.760416666666664,
5567,CDS,2586812,2587580,1,768,yqgB,62.760416666666664,
5569,CDS,2587995,2588424,-1,429,yqgA,62.93706293706294,cell wall protein
5568,gene,2587995,2588424,-1,429,yqgA,62.93706293706294,
5570,gene,2588700,2589000,1,300,yqfZ,57.99999999999999,
5571,CDS,2588700,2589000,1,300,yqfZ,57.99999999999999,
5573,CDS,2589122,2590256,1,1134,ispG,53.61552028218695,
5572,gene,2589122,2590256,1,1134,ispG,53.61552028218695,
5574,gene,2590281,2590671,-1,390,yqfX,55.38461538461539,
5575,CDS,2590281,2590671,-1,390,yqfX,55.38461538461539,
5576,gene,2590803,2591385,1,582,yqfW,60.824742268041234,
5577,CDS,2590803,2591385,1,582,yqfW,60.824742268041234,
5579,CDS,2591427,2591865,-1,438,zur,60.273972602739725,
5578,gene,2591427,2591865,-1,438,zur,60.273972602739725,
5580,gene,2592002,2592884,-1,882,yqfU,59.63718820861678,
5581,CDS,2592002,2592884,-1,882,yqfU,59.63718820861678,
5583,CDS,2592999,2593254,1,255,yqfT,63.13725490196078,
5582,gene,2592999,2593254,1,255,yqfT,63.13725490196078,
5584,gene,2593280,2594174,-1,894,nfo,57.94183445190156,
5585,CDS,2593280,2594174,-1,894,nfo,57.94183445190156,
5586,gene,2594183,2595500,-1,1317,cshB,57.327258921791945,
5587,CDS,2594183,2595500,-1,1317,cshB,57.327258921791945,
5588,gene,2595668,2596412,1,744,yqfQ,52.1505376344086,
5589,CDS,2595668,2596412,1,744,yqfQ,52.1505376344086,
5590,gene,2596534,2597479,1,945,ispH,57.14285714285714,
5591,CDS,2596534,2597479,1,945,ispH,57.14285714285714,
5592,gene,2597501,2598623,-1,1122,yqfO,56.14973262032086,
5593,CDS,2597501,2598623,-1,1122,yqfO,56.14973262032086,
5595,CDS,2598615,2599266,-1,651,trmK,53.149001536098304,
5594,gene,2598615,2599266,-1,651,trmK,53.149001536098304,
5597,CDS,2599522,2599885,-1,363,cccA,58.40220385674931,
5596,gene,2599522,2599885,-1,363,cccA,58.40220385674931,
5598,gene,2600213,2601329,-1,1116,sigA,57.52688172043011,
5599,CDS,2600213,2601329,-1,1116,sigA,57.52688172043011,
5601,CDS,2601527,2603339,-1,1812,dnaG,56.67770419426048,
5600,gene,2601527,2603339,-1,1812,dnaG,56.67770419426048,
5602,gene,2602978,2603275,1,297,antE,55.218855218855225,
5603,CDS,2602978,2603275,1,297,antE,55.218855218855225,
5604,gene,2603372,2603867,-1,495,yqxD,61.01010101010102,
5605,CDS,2603372,2603867,-1,495,yqxD,61.01010101010102,
5606,gene,2604120,2604933,-1,813,ppsR,59.286592865928654,
5607,CDS,2604120,2604933,-1,813,ppsR,59.286592865928654,
5608,gene,2604958,2605597,-1,639,ccpN,55.55555555555556,
5609,CDS,2604958,2605597,-1,639,ccpN,55.55555555555556,
5610,gene,2605729,2607769,-1,2040,glyS,55.7843137254902,
5611,CDS,2605729,2607769,-1,2040,glyS,55.7843137254902,
5613,CDS,2607761,2608649,-1,888,glyQ,54.729729729729726,
5612,gene,2607761,2608649,-1,888,glyQ,54.729729729729726,
5614,gene,2608731,2608906,-1,175,tboG,53.142857142857146,
5615,misc_RNA,2608731,2608906,-1,175,tboG,53.142857142857146,
5617,CDS,2608945,2609713,-1,768,recO,60.546875,
5616,gene,2608945,2609713,-1,768,recO,60.546875,
5618,gene,2609749,2609893,-1,144,yqzL,65.97222222222221,
5619,CDS,2609749,2609893,-1,144,yqzL,65.97222222222221,
5621,CDS,2610040,2610946,-1,906,era,56.84326710816777,
5620,gene,2610040,2610946,-1,906,era,56.84326710816777,
5622,gene,2610926,2611337,-1,411,cdd,54.98783454987834,
5623,CDS,2610926,2611337,-1,411,cdd,54.98783454987834,
5625,CDS,2611455,2611827,-1,372,unpK,55.107526881720425,
5624,gene,2611455,2611827,-1,372,unpK,55.107526881720425,
5626,gene,2611807,2612281,-1,474,rnrY,56.540084388185655,
5627,CDS,2611807,2612281,-1,474,rnrY,56.540084388185655,
5628,gene,2612281,2614417,-1,2136,pgpH,58.239700374531836,
5629,CDS,2612281,2614417,-1,2136,pgpH,58.239700374531836,
5631,CDS,2614495,2615455,-1,960,phoH,56.458333333333336,
5630,gene,2614495,2615455,-1,960,phoH,56.458333333333336,
5633,CDS,2615451,2616648,-1,1197,yqfD,59.14786967418546,
5632,gene,2615451,2616648,-1,1197,yqfD,59.14786967418546,
5635,CDS,2616666,2616948,-1,282,yqfC,56.02836879432624,
5634,gene,2616666,2616948,-1,282,yqfC,56.02836879432624,
5636,gene,2617004,2617424,-1,420,yqfB,54.52380952380952,
5637,CDS,2617004,2617424,-1,420,yqfB,54.52380952380952,
5639,CDS,2617448,2618444,-1,996,floA,52.40963855421686,
5638,gene,2617448,2618444,-1,996,floA,52.40963855421686,
5640,gene,2618465,2619779,-1,1314,nfeDA,53.57686453576864,
5641,CDS,2618465,2619779,-1,1314,nfeDA,53.57686453576864,
5642,gene,2619909,2620356,-1,447,yqeY,59.06040268456376,
5643,CDS,2619909,2620356,-1,447,yqeY,59.06040268456376,
5644,gene,2620370,2620544,-1,174,rpsU,60.91954022988506,
5645,CDS,2620370,2620544,-1,174,rpsU,60.91954022988506,
5646,gene,2620716,2621640,1,924,yqeW,56.493506493506494,
5647,CDS,2620716,2621640,1,924,yqeW,56.493506493506494,
5649,CDS,2621676,2623032,-1,1356,mtaB,56.48967551622419,
5648,gene,2621676,2623032,-1,1356,mtaB,56.48967551622419,
5651,CDS,2623031,2623802,-1,771,rsmE,53.69649805447471,
5650,gene,2623031,2623802,-1,771,rsmE,53.69649805447471,
5652,gene,2623824,2624760,-1,936,prmA,56.94444444444444,
5653,CDS,2623824,2624760,-1,936,prmA,56.94444444444444,
5654,gene,2624784,2625912,-1,1128,dnaJ,52.836879432624116,
5655,CDS,2624784,2625912,-1,1128,dnaJ,52.836879432624116,
5656,gene,2625951,2626042,1,91,surC,67.03296703296702,
5657,misc_RNA,2625951,2626042,1,91,surC,67.03296703296702,
5659,CDS,2626111,2627947,-1,1836,dnaK,55.88235294117647,
5658,gene,2626111,2627947,-1,1836,dnaK,55.88235294117647,
5660,gene,2627970,2628534,-1,564,grpE,56.91489361702128,
5661,CDS,2627970,2628534,-1,564,grpE,56.91489361702128,
5662,gene,2628605,2629637,-1,1032,hrcA,58.43023255813954,
5663,CDS,2628605,2629637,-1,1032,hrcA,58.43023255813954,
5664,gene,2629717,2630857,-1,1140,hemN,57.280701754385966,
5665,CDS,2629717,2630857,-1,1140,hemN,57.280701754385966,
5666,gene,2630909,2632748,-1,1839,lepA,53.072321914083744,
5667,CDS,2630909,2632748,-1,1839,lepA,53.072321914083744,
5668,gene,2632881,2633220,-1,339,yqxA,56.932153392330385,
5669,CDS,2632881,2633220,-1,339,yqxA,56.932153392330385,
5670,gene,2633236,2634442,-1,1206,spoIIP,54.47761194029851,
5671,CDS,2633236,2634442,-1,1206,spoIIP,54.47761194029851,
5672,gene,2634504,2635611,-1,1107,gpr,53.929539295392956,
5673,CDS,2634504,2635611,-1,1107,gpr,53.929539295392956,
5674,gene,2635814,2636081,1,267,rpsT,59.925093632958806,
5675,CDS,2635814,2636081,1,267,rpsT,59.925093632958806,
5676,gene,2636095,2637139,-1,1044,holA,58.333333333333336,
5677,CDS,2636095,2637139,-1,1044,holA,58.333333333333336,
5678,gene,2637178,2637328,-1,150,BSU_25565,58.666666666666664,
5679,CDS,2637178,2637328,-1,150,BSU_25565,58.666666666666664,
5681,CDS,2637368,2637503,1,135,yqzM,62.96296296296296,
5680,gene,2637368,2637503,1,135,yqzM,62.96296296296296,
5682,gene,2637542,2639873,-1,2331,comEC,55.51265551265552,
5683,CDS,2637542,2639873,-1,2331,comEC,55.51265551265552,
5684,gene,2639876,2640446,-1,570,comEB,56.49122807017544,
5685,CDS,2639876,2640446,-1,570,comEB,56.49122807017544,
5686,gene,2640512,2641130,-1,618,comEA,54.0453074433657,
5687,CDS,2640512,2641130,-1,618,comEA,54.0453074433657,
5688,gene,2641213,2642035,1,822,comER,56.812652068126525,
5689,CDS,2641213,2642035,1,822,comER,56.812652068126525,
5690,gene,2642100,2642844,-1,744,yqeM,55.91397849462365,
5691,CDS,2642100,2642844,-1,744,yqeM,55.91397849462365,
5692,gene,2642840,2643197,-1,357,rsfS,56.30252100840336,
5693,CDS,2642840,2643197,-1,357,rsfS,56.30252100840336,
5694,gene,2643214,2643775,-1,561,yqeK,54.367201426024955,
5695,CDS,2643214,2643775,-1,561,yqeK,54.367201426024955,
5697,CDS,2643764,2644334,-1,570,nadD,57.719298245614034,
5696,gene,2643764,2644334,-1,570,nadD,57.719298245614034,
5698,gene,2644345,2644636,-1,291,yqeI,60.48109965635739,
5699,CDS,2644345,2644636,-1,291,yqeI,60.48109965635739,
5700,gene,2644629,2645472,-1,843,aroE,56.93950177935944,
5701,CDS,2644629,2645472,-1,843,aroE,56.93950177935944,
5702,gene,2645489,2646590,-1,1101,rgpH,57.765667574931875,
5703,CDS,2645489,2646590,-1,1101,rgpH,57.765667574931875,
5705,CDS,2646593,2647112,-1,519,yqeG,57.03275529865125,
5704,gene,2646593,2647112,-1,519,yqeG,57.03275529865125,
5706,gene,2647404,2647663,-1,259,sdaM,66.79536679536679,
5707,misc_RNA,2647404,2647663,-1,259,sdaM,66.79536679536679,
5708,gene,2647455,2647614,1,159,sda,69.18238993710692,
5709,CDS,2647455,2647614,1,159,sda,69.18238993710692,
5710,gene,2647919,2648651,-1,732,yqeF,56.69398907103825,
5711,CDS,2647919,2648651,-1,732,yqeF,56.69398907103825,
5712,gene,2648902,2649655,-1,753,cwlH,55.77689243027888,
5713,CDS,2648902,2649655,-1,753,cwlH,55.77689243027888,
5715,CDS,2649841,2650468,1,627,yqeD,60.44657097288676,
5714,gene,2649841,2650468,1,627,yqeD,60.44657097288676,
5717,CDS,2650486,2651380,-1,894,yqeC,54.80984340044742,
5716,gene,2650486,2651380,-1,894,yqeC,54.80984340044742,
5718,gene,2651631,2652354,1,723,yqeB,55.325034578146614,
5719,CDS,2651631,2652354,1,723,yqeB,55.325034578146614,
5720,gene,2652386,2652797,-1,411,nucB,48.9051094890511,
5721,CDS,2652386,2652797,-1,411,nucB,48.9051094890511,
5722,gene,2652992,2653463,1,471,sigKn,59.660297239915074,
5723,misc_feature,2652992,2653463,1,471,sigKn,59.660297239915074,
5724,gene,2653370,2654873,-1,1503,spoIVCA,62.80771789753826,
5725,CDS,2653370,2654873,-1,1503,spoIVCA,62.80771789753826,
5726,gene,2655321,2655741,-1,420,arsC,59.523809523809526,
5727,CDS,2655321,2655741,-1,420,arsC,59.523809523809526,
5728,gene,2655752,2656793,-1,1041,arsB,63.88088376560999,
5729,CDS,2655752,2656793,-1,1041,arsB,63.88088376560999,
5730,gene,2656815,2657256,-1,441,yqcK,63.94557823129252,
5731,CDS,2656815,2657256,-1,441,yqcK,63.94557823129252,
5732,gene,2657316,2657634,-1,318,arsR,66.35220125786164,
5733,CDS,2657316,2657634,-1,318,arsR,66.35220125786164,
5734,gene,2658005,2658770,-1,765,yqcI,63.39869281045751,
5735,CDS,2658005,2658770,-1,765,yqcI,63.39869281045751,
5736,gene,2659212,2660340,1,1128,rapE,64.45035460992908,
5737,CDS,2659212,2660340,1,1128,rapE,64.45035460992908,
5738,gene,2660329,2660464,1,135,phrE,62.96296296296296,
5739,CDS,2660329,2660464,1,135,phrE,62.96296296296296,
5740,gene,2660573,2660732,1,159,yqzI,65.40880503144653,
5741,CDS,2660573,2660732,1,159,yqzI,65.40880503144653,
5743,CDS,2661101,2662697,1,1596,rttG,61.40350877192983,
5742,gene,2661101,2662697,1,1596,rttG,61.40350877192983,
5744,gene,2662711,2663290,1,579,rttF,64.59412780656304,
5745,CDS,2662711,2663290,1,579,rttF,64.59412780656304,
5746,gene,2663407,2663554,1,147,BSU_25875,65.98639455782312,
5747,CDS,2663407,2663554,1,147,BSU_25875,65.98639455782312,
5748,gene,2663550,2663913,-1,363,yqxJ,67.21763085399449,
5749,CDS,2663550,2663913,-1,363,yqxJ,67.21763085399449,
5750,gene,2663928,2664408,-1,480,yqxI,61.458333333333336,
5751,CDS,2663928,2664408,-1,480,yqxI,61.458333333333336,
5752,gene,2664572,2665391,-1,819,cwlA,59.34065934065934,
5753,CDS,2664572,2665391,-1,819,cwlA,59.34065934065934,
5754,gene,2665435,2665858,-1,423,yqxH,64.30260047281324,
5755,CDS,2665435,2665858,-1,423,yqxH,64.30260047281324,
5757,CDS,2665902,2666796,-1,894,yqxG,59.619686800894854,
5756,gene,2665902,2666796,-1,894,yqxG,59.619686800894854,
5758,gene,2666883,2667048,-1,165,yqcE,61.212121212121204,
5759,CDS,2666883,2667048,-1,165,yqcE,61.212121212121204,
5761,CDS,2667044,2667380,-1,336,yqcD,59.523809523809526,
5760,gene,2667044,2667380,-1,336,yqcD,59.523809523809526,
5762,gene,2667389,2668490,-1,1101,yqcC,61.76203451407811,
5763,CDS,2667389,2668490,-1,1101,yqcC,61.76203451407811,
5765,CDS,2668492,2668765,-1,273,yqcB,63.003663003663,
5764,gene,2668492,2668765,-1,273,yqcB,63.003663003663,
5766,gene,2668761,2669340,-1,579,yqcA,55.44041450777202,
5767,CDS,2668761,2669340,-1,579,yqcA,55.44041450777202,
5769,CDS,2669323,2670370,-1,1047,yqbT,55.873925501432666,
5768,gene,2669323,2670370,-1,1047,yqbT,55.873925501432666,
5770,gene,2670362,2670788,-1,426,yqbS,57.51173708920187,
5771,CDS,2670362,2670788,-1,426,yqbS,57.51173708920187,
5772,gene,2670800,2671064,-1,264,yqbR,59.09090909090909,
5773,CDS,2670800,2671064,-1,264,yqbR,59.09090909090909,
5775,CDS,2671060,2672041,-1,981,yqbQ,57.08460754332314,
5774,gene,2671060,2672041,-1,981,yqbQ,57.08460754332314,
5777,CDS,2672053,2672713,-1,660,yqbP,61.212121212121204,
5776,gene,2672053,2672713,-1,660,yqbP,61.212121212121204,
5779,CDS,2672705,2677463,-1,4758,yqbO,56.76754939050021,
5778,gene,2672705,2677463,-1,4758,yqbO,56.76754939050021,
5780,gene,2677465,2677657,-1,192,yqbNc,59.895833333333336,
5781,misc_feature,2677465,2677657,-1,192,yqbNc,59.895833333333336,
5783,misc_feature,2677656,2678094,-1,438,yqbNn,59.3607305936073,
5782,gene,2677656,2678094,-1,438,yqbNn,59.3607305936073,
5784,gene,2678239,2678419,1,180,txpA,63.888888888888886,
5785,CDS,2678239,2678419,1,180,txpA,63.888888888888886,
5786,gene,2678342,2678565,-1,223,ratA,63.67713004484305,
5787,misc_RNA,2678342,2678565,-1,223,ratA,63.67713004484305,
5789,CDS,2678798,2678888,1,90,bsrH,65.55555555555556,
5788,gene,2678798,2678888,1,90,bsrH,65.55555555555556,
5790,gene,2678875,2679014,-1,139,asrH,54.67625899280576,
5791,misc_RNA,2678875,2679014,-1,139,asrH,54.67625899280576,
5793,CDS,2679141,2679585,-1,444,yqbM,57.88288288288288,
5792,gene,2679141,2679585,-1,444,yqbM,57.88288288288288,
5794,gene,2679587,2680988,-1,1401,yqbK,57.31620271234832,
5795,CDS,2679587,2680988,-1,1401,yqbK,57.31620271234832,
5797,CDS,2680988,2681180,-1,192,yqzN,61.979166666666664,
5796,gene,2680988,2681180,-1,192,yqzN,61.979166666666664,
5798,gene,2681176,2681614,-1,438,yqbJ,57.534246575342465,
5799,CDS,2681176,2681614,-1,438,yqbJ,57.534246575342465,
5800,gene,2681626,2682130,-1,504,yqbI,54.96031746031746,
5801,CDS,2681626,2682130,-1,504,yqbI,54.96031746031746,
5802,gene,2682126,2682489,-1,363,yqbH,58.95316804407713,
5803,CDS,2682126,2682489,-1,363,yqbH,58.95316804407713,
5804,gene,2682485,2682881,-1,396,yqbG,62.37373737373737,
5805,CDS,2682485,2682881,-1,396,yqbG,62.37373737373737,
5806,gene,2682884,2683196,-1,312,yqbF,65.06410256410257,
5807,CDS,2682884,2683196,-1,312,yqbF,65.06410256410257,
5808,gene,2683206,2684142,-1,936,yqbE,58.97435897435898,
5809,CDS,2683206,2684142,-1,936,yqbE,58.97435897435898,
5811,CDS,2684160,2685129,-1,969,yqbD,58.92672858617131,
5810,gene,2684160,2685129,-1,969,yqbD,58.92672858617131,
5813,CDS,2685161,2685815,-1,654,yqbC,70.33639143730886,
5812,gene,2685161,2685815,-1,654,yqbC,70.33639143730886,
5814,gene,2685855,2686773,-1,918,yqbB,57.29847494553377,
5815,CDS,2685855,2686773,-1,918,yqbB,57.29847494553377,
5816,gene,2686769,2688302,-1,1533,yqbA,60.99151989562949,
5817,CDS,2686769,2688302,-1,1533,yqbA,60.99151989562949,
5818,gene,2688305,2689601,-1,1296,yqaT,58.71913580246913,
5819,CDS,2688305,2689601,-1,1296,yqaT,58.71913580246913,
5820,gene,2689593,2690313,-1,720,yqaS,59.72222222222222,
5821,CDS,2689593,2690313,-1,720,yqaS,59.72222222222222,
5822,gene,2690380,2690845,-1,465,yqaR,72.68817204301075,
5823,CDS,2690380,2690845,-1,465,yqaR,72.68817204301075,
5824,gene,2690988,2691444,-1,456,yqaQ,59.86842105263158,
5825,CDS,2690988,2691444,-1,456,yqaQ,59.86842105263158,
5827,CDS,2691641,2692571,1,930,yqaP,67.95698924731182,
5826,gene,2691641,2692571,1,930,yqaP,67.95698924731182,
5829,CDS,2692644,2692851,-1,207,yqaO,60.38647342995169,
5828,gene,2692644,2692851,-1,207,yqaO,60.38647342995169,
5830,gene,2692932,2693361,-1,429,yqaN,57.57575757575758,
5831,CDS,2692932,2693361,-1,429,yqaN,57.57575757575758,
5832,gene,2693456,2693606,-1,150,yqzO,64.66666666666666,
5833,CDS,2693456,2693606,-1,150,yqzO,64.66666666666666,
5835,CDS,2693596,2694538,-1,942,sknM,59.87261146496815,
5834,gene,2693596,2694538,-1,942,sknM,59.87261146496815,
5837,CDS,2694419,2695097,-1,678,yqaL,58.11209439528023,
5836,gene,2694419,2695097,-1,678,yqaL,58.11209439528023,
5838,gene,2695172,2696027,-1,855,yqaK,59.76608187134504,
5839,CDS,2695172,2696027,-1,855,yqaK,59.76608187134504,
5840,gene,2696029,2696989,-1,960,yqaJ,59.68750000000001,
5841,CDS,2696029,2696989,-1,960,yqaJ,59.68750000000001,
5842,gene,2697094,2697289,-1,195,yqaI,62.05128205128205,
5843,CDS,2697094,2697289,-1,195,yqaI,62.05128205128205,
5845,CDS,2697248,2697422,-1,174,BSU_26305,60.91954022988506,
5844,gene,2697248,2697422,-1,174,BSU_26305,60.91954022988506,
5847,CDS,2697418,2697676,-1,258,sknH,59.68992248062015,
5846,gene,2697418,2697676,-1,258,sknH,59.68992248062015,
5848,gene,2697672,2698242,-1,570,yqaG,57.19298245614035,
5849,CDS,2697672,2698242,-1,570,yqaG,57.19298245614035,
5850,gene,2698315,2698456,-1,141,yqdA,59.57446808510638,
5851,CDS,2698315,2698456,-1,141,yqdA,59.57446808510638,
5853,CDS,2698485,2698716,-1,231,yqaF,64.5021645021645,
5852,gene,2698485,2698716,-1,231,yqaF,64.5021645021645,
5855,CDS,2698892,2699243,1,351,sknR,64.1025641025641,
5854,gene,2698892,2699243,1,351,sknR,64.1025641025641,
5856,gene,2699509,2699677,-1,168,yqaD,79.16666666666666,
5857,CDS,2699509,2699677,-1,168,yqaD,79.16666666666666,
5858,gene,2700032,2700569,-1,537,yqaC,62.75605214152699,
5859,CDS,2700032,2700569,-1,537,yqaC,62.75605214152699,
5860,gene,2700837,2701356,1,519,yqaB,64.9325626204239,
5861,CDS,2700837,2701356,1,519,yqaB,64.9325626204239,
5863,misc_feature,2701337,2701754,1,417,sigKc,57.07434052757794,
5862,gene,2701337,2701754,1,417,sigKc,57.07434052757794,
5865,CDS,2701753,2701870,1,117,BSU_26399,60.68376068376068,
5864,gene,2701753,2701870,1,117,BSU_26399,60.68376068376068,
5866,gene,2701978,2702143,-1,165,yrkS,58.78787878787879,
5867,CDS,2701978,2702143,-1,165,yrkS,58.78787878787879,
5868,gene,2702687,2703104,-1,417,psiE,61.15107913669065,
5869,CDS,2702687,2703104,-1,417,psiE,61.15107913669065,
5870,gene,2703149,2704448,-1,1299,yrkQ,57.736720554272516,
5871,CDS,2703149,2704448,-1,1299,yrkQ,57.736720554272516,
5872,gene,2704434,2705130,-1,696,yrkP,57.18390804597702,
5873,CDS,2704434,2705130,-1,696,yrkP,57.18390804597702,
5874,gene,2705397,2706615,1,1218,yrkO,55.74712643678161,
5875,CDS,2705397,2706615,1,1218,yrkO,55.74712643678161,
5876,gene,2706533,2706782,1,249,BSU_26449,59.83935742971887,
5877,CDS,2706533,2706782,1,249,BSU_26449,59.83935742971887,
5879,CDS,2707126,2707684,1,558,yrkN,60.39426523297491,
5878,gene,2707126,2707684,1,558,yrkN,60.39426523297491,
5881,CDS,2708174,2708699,-1,525,yrkL,60.1904761904762,
5880,gene,2708174,2708699,-1,525,yrkL,60.1904761904762,
5883,CDS,2708942,2709419,-1,477,yrkK,69.60167714884696,
5882,gene,2708942,2709419,-1,477,yrkK,69.60167714884696,
5884,gene,2710001,2710787,-1,786,yrkJ,62.72264631043257,
5885,CDS,2710001,2710787,-1,786,yrkJ,62.72264631043257,
5886,gene,2710847,2711075,-1,228,yrkI,60.526315789473685,
5887,CDS,2710847,2711075,-1,228,yrkI,60.526315789473685,
5888,gene,2711108,2712242,-1,1134,yrkH,60.14109347442681,
5889,CDS,2711108,2712242,-1,1134,yrkH,60.14109347442681,
5891,CDS,2712576,2713134,-1,558,yrkF,60.39426523297491,
5890,gene,2712576,2713134,-1,558,yrkF,60.39426523297491,
5892,gene,2713319,2713802,-1,483,yrkE,62.31884057971014,
5893,CDS,2713319,2713802,-1,483,yrkE,62.31884057971014,
5894,gene,2713948,2714140,-1,192,yrkD,59.895833333333336,
5895,CDS,2713948,2714140,-1,192,yrkD,59.895833333333336,
5897,misc_feature,2714230,2714548,-1,318,yrzM,67.9245283018868,
5896,gene,2714230,2714548,-1,318,yrzM,67.9245283018868,
5899,misc_feature,2714589,2714805,-1,216,yrzN,68.98148148148148,
5898,gene,2714589,2714805,-1,216,yrzN,68.98148148148148,
5901,CDS,2714932,2715493,-1,561,yrkC,60.60606060606061,
5900,gene,2714932,2715493,-1,561,yrkC,60.60606060606061,
5902,gene,2715509,2715686,-1,177,BSU_26569,70.05649717514125,
5903,CDS,2715509,2715686,-1,177,BSU_26569,70.05649717514125,
5905,CDS,2715718,2715865,-1,147,yrkB,57.82312925170068,
5904,gene,2715718,2715865,-1,147,yrkB,57.82312925170068,
5906,gene,2716034,2716856,-1,822,bltR,65.81508515815085,
5907,CDS,2716034,2716856,-1,822,bltR,65.81508515815085,
5908,gene,2716972,2718175,1,1203,blt,61.014131338320865,
5909,CDS,2716972,2718175,1,1203,blt,61.014131338320865,
5911,CDS,2718343,2718802,1,459,bltD,66.01307189542483,
5910,gene,2718343,2718802,1,459,bltD,66.01307189542483,
5912,gene,2718958,2720263,-1,1305,yrkA,63.678160919540225,
5913,CDS,2718958,2720263,-1,1305,yrkA,63.678160919540225,
5915,CDS,2720525,2720669,-1,144,yrzO,71.52777777777779,
5914,gene,2720525,2720669,-1,144,yrzO,71.52777777777779,
5916,gene,2720686,2721652,-1,966,yrdR,64.90683229813664,
5917,CDS,2720686,2721652,-1,966,yrdR,64.90683229813664,
5919,CDS,2721777,2722644,1,867,czcR,61.5916955017301,
5918,gene,2721777,2722644,1,867,czcR,61.5916955017301,
5920,gene,2722766,2723804,-1,1038,yrdP,66.1849710982659,
5921,CDS,2722766,2723804,-1,1038,yrdP,66.1849710982659,
5923,CDS,2723891,2724827,-1,936,czcD,61.75213675213676,
5922,gene,2723891,2724827,-1,936,czcD,61.75213675213676,
5924,gene,2725113,2725503,-1,390,yrdN,64.1025641025641,
5925,CDS,2725113,2725503,-1,390,yrdN,64.1025641025641,
5926,gene,2725836,2726727,1,891,gltR,60.04489337822672,
5927,CDS,2725836,2726727,1,891,gltR,60.04489337822672,
5928,gene,2726884,2727202,-1,318,yrdK,60.062893081761004,
5929,CDS,2726884,2727202,-1,318,yrdK,60.062893081761004,
5930,gene,2727159,2728482,-1,1323,brnQ,60.92214663643235,
5931,CDS,2727159,2728482,-1,1323,brnQ,60.92214663643235,
5933,CDS,2728646,2728979,-1,333,azlD,56.75675675675676,
5932,gene,2728646,2728979,-1,333,azlD,56.75675675675676,
5935,CDS,2728975,2729740,-1,765,azlC,61.04575163398693,
5934,gene,2728975,2729740,-1,765,azlC,61.04575163398693,
5936,gene,2729752,2730226,-1,474,azlB,63.71308016877637,
5937,CDS,2729752,2730226,-1,474,azlB,63.71308016877637,
5938,gene,2730559,2730835,-1,276,yrdF,66.66666666666666,
5939,CDS,2730559,2730835,-1,276,yrdF,66.66666666666666,
5940,gene,2731106,2732339,-1,1233,cypA,60.908353609083534,
5941,CDS,2731106,2732339,-1,1233,cypA,60.908353609083534,
5943,misc_feature,2732388,2732547,-1,159,yrdDc,63.52201257861635,
5942,gene,2732388,2732547,-1,159,yrdDc,63.52201257861635,
5944,gene,2732546,2732747,-1,201,yrdDm,64.6766169154229,
5945,misc_feature,2732546,2732747,-1,201,yrdDm,64.6766169154229,
5946,gene,2732746,2732881,-1,135,yrdDn,68.88888888888889,
5947,misc_feature,2732746,2732881,-1,135,yrdDn,68.88888888888889,
5948,gene,2732979,2733543,-1,564,yrdC,65.95744680851064,
5949,CDS,2732979,2733543,-1,564,yrdC,65.95744680851064,
5950,gene,2733771,2734143,-1,372,yrdB,66.39784946236558,
5951,CDS,2733771,2734143,-1,372,yrdB,66.39784946236558,
5953,CDS,2734952,2735456,-1,504,yrdA,60.912698412698404,
5952,gene,2734952,2735456,-1,504,yrdA,60.912698412698404,
5955,CDS,2735681,2736536,-1,855,aadK,63.74269005847953,
5954,gene,2735681,2736536,-1,855,aadK,63.74269005847953,
5956,gene,2736914,2737958,1,1044,yrpB,59.00383141762452,
5957,CDS,2736914,2737958,1,1044,yrpB,59.00383141762452,
5958,gene,2738307,2739105,1,798,murI,65.28822055137844,
5959,CDS,2738307,2739105,1,798,murI,65.28822055137844,
5960,gene,2739485,2740193,1,708,yrpD,55.367231638418076,
5961,CDS,2739485,2740193,1,708,yrpD,55.367231638418076,
5962,gene,2740516,2740678,1,162,BSU_26829,61.72839506172839,
5963,misc_feature,2740516,2740678,1,162,BSU_26829,61.72839506172839,
5964,gene,2740768,2740846,1,78,yrpDX,65.38461538461539,
5965,CDS,2740768,2740846,1,78,yrpDX,65.38461538461539,
5966,gene,2741132,2741294,-1,162,BSU_26827,63.580246913580254,
5967,CDS,2741132,2741294,-1,162,BSU_26827,63.580246913580254,
5969,CDS,2741356,2742112,-1,756,zinT,61.50793650793651,
5968,gene,2741356,2742112,-1,756,zinT,61.50793650793651,
5971,CDS,2742243,2742774,-1,531,sigZ,61.5819209039548,
5970,gene,2742243,2742774,-1,531,sigZ,61.5819209039548,
5972,gene,2742908,2743889,1,981,yrpG,54.230377166156984,
5973,CDS,2742908,2743889,1,981,yrpG,54.230377166156984,
5974,gene,2744162,2745479,-1,1317,yraO,60.89597570235383,
5975,CDS,2744162,2745479,-1,1317,yraO,60.89597570235383,
5977,CDS,2745593,2746463,-1,870,yraN,62.87356321839081,
5976,gene,2745593,2746463,-1,870,yraN,62.87356321839081,
5979,CDS,2746607,2747711,1,1104,prpF,57.427536231884055,
5978,gene,2746607,2747711,1,1104,prpF,57.427536231884055,
5980,gene,2747983,2748817,-1,834,csn,55.15587529976019,
5981,CDS,2747983,2748817,-1,834,csn,55.15587529976019,
5982,gene,2749259,2749523,1,264,yraL,67.42424242424242,
5983,CDS,2749259,2749523,1,264,yraL,67.42424242424242,
5984,gene,2749659,2750475,1,816,yraK,54.53431372549019,
5985,CDS,2749659,2750475,1,816,yraK,54.53431372549019,
5987,CDS,2750882,2751239,-1,357,yraJ,56.022408963585434,
5986,gene,2750882,2751239,-1,357,yraJ,56.022408963585434,
5989,CDS,2751291,2751651,-1,360,yraI,52.5,
5988,gene,2751291,2751651,-1,360,yraI,52.5,
5990,gene,2751922,2752024,-1,102,BSU_26935,57.84313725490197,
5991,CDS,2751922,2752024,-1,102,BSU_26935,57.84313725490197,
5992,gene,2752166,2752553,-1,387,yraH,64.85788113695091,
5993,CDS,2752166,2752553,-1,387,yraH,64.85788113695091,
5995,CDS,2752801,2753047,1,246,yraG,57.72357723577236,
5994,gene,2752801,2753047,1,246,yraG,57.72357723577236,
5997,CDS,2753064,2753433,1,369,yraF,56.36856368563685,
5996,gene,2753064,2753433,1,369,yraF,56.36856368563685,
5998,gene,2753451,2754588,1,1137,adhB,56.81618293755497,
5999,CDS,2753451,2754588,1,1137,adhB,56.81618293755497,
6000,gene,2754606,2754804,1,198,yraE,60.60606060606061,
6001,CDS,2754606,2754804,1,198,yraE,60.60606060606061,
6002,gene,2754819,2755119,1,300,yraD,59.333333333333336,
6003,CDS,2754819,2755119,1,300,yraD,59.333333333333336,
6005,CDS,2755381,2755804,-1,423,adhR,58.392434988179666,
6004,gene,2755381,2755804,-1,423,adhR,58.392434988179666,
6007,CDS,2755986,2756181,1,195,yrzP,61.02564102564103,
6006,gene,2755986,2756181,1,195,yrzP,61.02564102564103,
6008,gene,2756311,2757361,1,1050,adhA,52.476190476190474,
6009,CDS,2756311,2757361,1,1050,adhA,52.476190476190474,
6010,gene,2757491,2758001,1,510,sufL,57.25490196078431,
6011,CDS,2757491,2758001,1,510,sufL,57.25490196078431,
6012,gene,2758042,2760076,-1,2034,sacC,54.52310717797444,
6013,CDS,2758042,2760076,-1,2034,sacC,54.52310717797444,
6014,gene,2759984,2760152,-1,168,BSU_27035,55.35714285714286,
6015,CDS,2759984,2760152,-1,168,BSU_27035,55.35714285714286,
6016,gene,2760232,2761060,-1,828,levG,55.67632850241546,
6017,CDS,2760232,2761060,-1,828,levG,55.67632850241546,
6018,gene,2761080,2761890,-1,810,levF,54.19753086419753,
6019,CDS,2761080,2761890,-1,810,levF,54.19753086419753,
6020,gene,2761906,2762395,-1,489,levE,56.646216768916155,
6021,CDS,2761906,2762395,-1,489,levE,56.646216768916155,
6023,CDS,2762394,2762835,-1,441,levD,59.183673469387756,
6022,gene,2762394,2762835,-1,441,levD,59.183673469387756,
6025,CDS,2763024,2765832,-1,2808,levR,59.22364672364673,
6024,gene,2763024,2765832,-1,2808,levR,59.22364672364673,
6026,gene,2766378,2766519,1,141,BSU_27085,73.04964539007092,
6027,CDS,2766378,2766519,1,141,BSU_27085,73.04964539007092,
6028,gene,2766557,2767946,1,1389,aapA,57.88336933045356,
6029,CDS,2766557,2767946,1,1389,aapA,57.88336933045356,
6031,CDS,2768041,2768674,-1,633,yrhP,62.7172195892575,
6030,gene,2768041,2768674,-1,633,yrhP,62.7172195892575,
6033,CDS,2768826,2769654,1,828,yrhO,59.78260869565217,
6032,gene,2768826,2769654,1,828,yrhO,59.78260869565217,
6034,gene,2769849,2770350,1,501,sigV,62.4750499001996,
6035,CDS,2769849,2770350,1,501,sigV,62.4750499001996,
6036,gene,2770349,2771207,1,858,rsiV,61.65501165501166,
6037,CDS,2770349,2771207,1,858,rsiV,61.65501165501166,
6039,CDS,2771317,2773222,1,1905,oatA,56.90288713910762,
6038,gene,2771317,2773222,1,1905,oatA,56.90288713910762,
6040,gene,2773355,2773646,1,291,yrhK,62.19931271477663,
6041,CDS,2773355,2773646,1,291,yrhK,62.19931271477663,
6043,misc_RNA,2773782,2773883,1,101,surF,53.46534653465347,
6042,gene,2773782,2773883,1,101,surF,53.46534653465347,
6044,gene,2773889,2777054,-1,3165,cypB,53.396524486571884,
6045,CDS,2773889,2777054,-1,3165,cypB,53.396524486571884,
6046,gene,2777069,2777654,-1,585,bscR,60.34188034188034,
6047,CDS,2777069,2777654,-1,585,bscR,60.34188034188034,
6048,gene,2777876,2778419,-1,543,yrhH,63.35174953959485,
6049,CDS,2777876,2778419,-1,543,yrhH,63.35174953959485,
6051,CDS,2778607,2778766,-1,159,BSU_27185,54.71698113207547,
6050,gene,2778607,2778766,-1,159,BSU_27185,54.71698113207547,
6053,CDS,2778922,2779072,-1,150,yrzI,68.0,
6052,gene,2778922,2779072,-1,150,yrzI,68.0,
6054,gene,2779461,2780262,-1,801,yrhG,54.18227215980025,
6055,CDS,2779461,2780262,-1,801,yrhG,54.18227215980025,
6056,gene,2780524,2780893,-1,369,yrhF,60.97560975609756,
6057,CDS,2780524,2780893,-1,369,yrhF,60.97560975609756,
6059,CDS,2781208,2784151,1,2943,yrhE,53.41488277268094,
6058,gene,2781208,2784151,1,2943,yrhE,53.41488277268094,
6061,CDS,2784169,2784652,1,483,yrhD,55.072463768115945,
6060,gene,2784169,2784652,1,483,yrhD,55.072463768115945,
6062,gene,2784687,2784918,-1,231,yrhC,61.038961038961034,
6063,CDS,2784687,2784918,-1,231,yrhC,61.038961038961034,
6064,gene,2785000,2786140,-1,1140,mccB,53.333333333333336,
6065,CDS,2785000,2786140,-1,1140,mccB,53.333333333333336,
6066,gene,2786141,2787065,-1,924,mccA,53.57142857142857,
6067,CDS,2786141,2787065,-1,924,mccA,53.57142857142857,
6068,gene,2787129,2787825,-1,696,mtnN,55.31609195402298,
6069,CDS,2787129,2787825,-1,696,mtnN,55.31609195402298,
6070,gene,2787845,2788487,-1,642,yrrT,56.074766355140184,
6071,CDS,2787845,2788487,-1,642,yrrT,56.074766355140184,
6072,gene,2788679,2788883,1,204,yrzA,62.254901960784316,
6073,CDS,2788679,2788883,1,204,yrzA,62.254901960784316,
6075,CDS,2788919,2789621,-1,702,yrrS,57.54985754985755,
6074,gene,2788919,2789621,-1,702,yrrS,57.54985754985755,
6077,CDS,2789685,2791440,-1,1755,pbpI,56.18233618233618,
6076,gene,2789685,2791440,-1,1755,pbpI,56.18233618233618,
6078,gene,2791493,2791967,-1,474,greA,57.17299578059072,
6079,CDS,2791493,2791967,-1,474,greA,57.17299578059072,
6080,gene,2792217,2792853,-1,636,udk,58.9622641509434,
6081,CDS,2792217,2792853,-1,636,udk,58.9622641509434,
6083,CDS,2792859,2794128,-1,1269,yrrO,54.45232466509062,
6082,gene,2792859,2794128,-1,1269,yrrO,54.45232466509062,
6085,CDS,2794146,2795076,-1,930,yrrN,56.666666666666664,
6084,gene,2794146,2795076,-1,930,yrrN,56.666666666666664,
6086,gene,2795081,2795735,-1,654,yrrM,57.798165137614674,
6087,CDS,2795081,2795735,-1,654,yrrM,57.798165137614674,
6088,gene,2795886,2796969,-1,1083,yrrL,60.11080332409973,
6089,CDS,2795886,2796969,-1,1083,yrrL,60.11080332409973,
6090,gene,2797099,2797381,-1,282,yrzB,61.347517730496456,
6091,CDS,2797099,2797381,-1,282,yrzB,61.347517730496456,
6093,CDS,2797398,2797815,-1,417,rimF,57.31414868105516,
6092,gene,2797398,2797815,-1,417,rimF,57.31414868105516,
6094,gene,2797822,2798089,-1,267,yrzL,59.176029962546814,
6095,CDS,2797822,2798089,-1,267,yrzL,59.176029962546814,
6097,CDS,2798173,2800810,-1,2637,alaS,53.12855517633675,
6096,gene,2798173,2800810,-1,2637,alaS,53.12855517633675,
6098,gene,2800889,2801097,-1,208,tboA,48.07692307692308,
6099,misc_RNA,2800889,2801097,-1,208,tboA,48.07692307692308,
6100,gene,2801140,2802202,-1,1062,yrrI,54.33145009416196,
6101,CDS,2801140,2802202,-1,1062,yrrI,54.33145009416196,
6102,gene,2802357,2803086,1,729,glnQ,54.1838134430727,
6103,CDS,2802357,2803086,1,729,glnQ,54.1838134430727,
6104,gene,2803107,2803929,1,822,glnH,59.00243309002433,
6105,CDS,2803107,2803929,1,822,glnH,59.00243309002433,
6106,gene,2803989,2804640,1,651,glnM,54.99231950844854,
6107,CDS,2803989,2804640,1,651,glnM,54.99231950844854,
6108,gene,2804656,2805313,1,657,glnP,54.794520547945204,
6109,CDS,2804656,2805313,1,657,glnP,54.794520547945204,
6110,gene,2805347,2805479,-1,132,yrzQ,56.060606060606055,
6111,CDS,2805347,2805479,-1,132,yrzQ,56.060606060606055,
6113,CDS,2805500,2805692,-1,192,yrzR,58.333333333333336,
6112,gene,2805500,2805692,-1,192,yrzR,58.333333333333336,
6115,CDS,2805703,2806228,-1,525,yrrD,55.61904761904762,
6114,gene,2805703,2806228,-1,525,yrrD,55.61904761904762,
6116,gene,2806285,2808682,-1,2397,recDB,54.15102211097205,
6117,CDS,2806285,2808682,-1,2397,recDB,54.15102211097205,
6118,gene,2808706,2809327,-1,621,yrrB,54.911433172302736,
6119,CDS,2808706,2809327,-1,621,yrrB,54.911433172302736,
6121,CDS,2809412,2810528,-1,1116,mnmA,52.41935483870967,
6120,gene,2809412,2810528,-1,1116,mnmA,52.41935483870967,
6123,CDS,2810558,2811698,-1,1140,iscSA,51.84210526315789,
6122,gene,2810558,2811698,-1,1140,iscSA,51.84210526315789,
6124,gene,2811716,2812133,-1,417,cymR,52.99760191846523,
6125,CDS,2811716,2812133,-1,417,cymR,52.99760191846523,
6126,gene,2812335,2813601,1,1266,rarA,54.02843601895735,
6127,CDS,2812335,2813601,1,1266,rarA,54.02843601895735,
6129,CDS,2813642,2814407,-1,765,tcdA,55.42483660130719,
6128,gene,2813642,2814407,-1,765,tcdA,55.42483660130719,
6130,gene,2814490,2814691,-1,201,ssrSB,58.70646766169154,
6131,misc_RNA,2814490,2814691,-1,201,ssrSB,58.70646766169154,
6133,CDS,2814742,2816521,-1,1779,aspS,52.27655986509275,
6132,gene,2814742,2816521,-1,1779,aspS,52.27655986509275,
6134,gene,2816534,2817809,-1,1275,hisS,54.90196078431373,
6135,CDS,2816534,2817809,-1,1275,hisS,54.90196078431373,
6136,gene,2817898,2818131,-1,233,tboH,50.21459227467812,
6137,misc_RNA,2817898,2818131,-1,233,tboH,50.21459227467812,
6138,gene,2818190,2818361,-1,171,yrzK,56.14035087719298,
6139,CDS,2818190,2818361,-1,171,yrzK,56.14035087719298,
6141,CDS,2818493,2820050,1,1557,yrvJ,51.76621708413616,
6140,gene,2818493,2820050,1,1557,yrvJ,51.76621708413616,
6143,CDS,2820076,2820475,-1,399,dtd,55.639097744360896,
6142,gene,2820076,2820475,-1,399,dtd,55.639097744360896,
6144,gene,2820528,2822733,-1,2205,rsh,55.69160997732426,
6145,CDS,2820528,2822733,-1,2205,rsh,55.69160997732426,
6146,gene,2822900,2823413,-1,513,apt,55.945419103313846,
6147,CDS,2822900,2823413,-1,513,apt,55.945419103313846,
6149,CDS,2823418,2825779,-1,2361,recJ,53.70605675561203,
6148,gene,2823418,2825779,-1,2361,recJ,53.70605675561203,
6151,CDS,2825845,2826169,-1,324,yrvD,62.34567901234568,
6150,gene,2825845,2826169,-1,324,yrvD,62.34567901234568,
6152,gene,2826244,2826742,-1,498,yrvC,55.82329317269076,
6153,CDS,2826244,2826742,-1,498,yrvC,55.82329317269076,
6154,gene,2826899,2829113,-1,2214,secDF,56.639566395663955,
6155,CDS,2826899,2829113,-1,2214,secDF,56.639566395663955,
6156,gene,2829151,2829448,-1,297,comN,58.92255892255892,
6157,CDS,2829151,2829448,-1,297,comN,58.92255892255892,
6158,gene,2829563,2831120,1,1557,spoVB,52.601156069364166,
6159,CDS,2829563,2831120,1,1557,spoVB,52.601156069364166,
6160,gene,2831123,2831780,-1,657,yrbG,61.18721461187214,
6161,CDS,2831123,2831780,-1,657,yrbG,61.18721461187214,
6162,gene,2831914,2832367,1,453,yrzE,56.5121412803532,
6163,CDS,2831914,2832367,1,453,yrzE,56.5121412803532,
6165,CDS,2832423,2832690,-1,267,yrbF,55.430711610486895,
6164,gene,2832423,2832690,-1,267,yrbF,55.430711610486895,
6167,CDS,2832726,2833872,-1,1146,tgt,52.879581151832454,
6166,gene,2832726,2833872,-1,1146,tgt,52.879581151832454,
6168,gene,2833898,2834927,-1,1029,queA,54.22740524781341,
6169,CDS,2833898,2834927,-1,1029,queA,54.22740524781341,
6170,gene,2834956,2835157,-1,201,yrzS,67.16417910447761,
6171,CDS,2834956,2835157,-1,201,yrzS,67.16417910447761,
6172,gene,2835149,2836154,-1,1005,ruvB,49.850746268656714,
6173,CDS,2835149,2836154,-1,1005,ruvB,49.850746268656714,
6174,gene,2836164,2836770,-1,606,ruvA,59.240924092409244,
6175,CDS,2836164,2836770,-1,606,ruvA,59.240924092409244,
6176,gene,2836908,2837421,-1,513,bofC,53.606237816764136,
6177,CDS,2836908,2837421,-1,513,bofC,53.606237816764136,
6178,gene,2837468,2838776,-1,1308,csbX,53.669724770642205,
6179,CDS,2837468,2838776,-1,1308,csbX,53.669724770642205,
6181,CDS,2838846,2839872,-1,1026,yrbE,54.58089668615984,
6180,gene,2838846,2839872,-1,1026,yrbE,54.58089668615984,
6183,CDS,2840109,2840757,1,648,yrzF,57.098765432098766,
6182,gene,2840109,2840757,1,648,yrzF,57.098765432098766,
6184,gene,2840802,2840925,-1,123,BSU_27786,56.09756097560976,
6185,CDS,2840802,2840925,-1,123,BSU_27786,56.09756097560976,
6186,gene,2841009,2841300,1,291,yrzH,57.388316151202744,
6187,CDS,2841009,2841300,1,291,yrzH,57.388316151202744,
6189,CDS,2841306,2841447,1,141,yrzT,67.37588652482269,
6188,gene,2841306,2841447,1,141,yrzT,67.37588652482269,
6191,CDS,2841610,2843065,1,1455,alaP,52.98969072164949,
6190,gene,2841610,2843065,1,1455,alaP,52.98969072164949,
6192,gene,2843105,2843828,-1,723,yrbC,56.016597510373444,
6193,CDS,2843105,2843828,-1,723,yrbC,56.016597510373444,
6194,gene,2843930,2844527,-1,597,sgpA,56.11390284757118,
6195,CDS,2843930,2844527,-1,597,sgpA,56.11390284757118,
6196,gene,2844674,2845838,-1,1164,safA,53.264604810996566,
6197,CDS,2844674,2845838,-1,1164,safA,53.264604810996566,
6199,CDS,2845954,2847061,-1,1107,nadA,55.37488708220416,
6198,gene,2845954,2847061,-1,1107,nadA,55.37488708220416,
6201,CDS,2847047,2847917,-1,870,nadC,56.55172413793104,
6200,gene,2847047,2847917,-1,870,nadC,56.55172413793104,
6202,gene,2847870,2849466,-1,1596,nadB,53.32080200501254,
6203,CDS,2847870,2849466,-1,1596,nadB,53.32080200501254,
6204,gene,2849568,2850756,1,1188,nifS,56.060606060606055,
6205,CDS,2849568,2850756,1,1188,nifS,56.060606060606055,
6207,CDS,2850715,2851258,1,543,niaR,52.67034990791897,
6206,gene,2850715,2851258,1,543,niaR,52.67034990791897,
6209,CDS,2851282,2852140,-1,858,pheA,56.993006993006986,
6208,gene,2851282,2852140,-1,858,pheA,56.993006993006986,
6210,gene,2852156,2852600,-1,444,thrR,61.03603603603604,
6211,CDS,2852156,2852600,-1,444,thrR,61.03603603603604,
6212,gene,2852660,2853947,-1,1287,obgE,51.592851592851595,
6213,CDS,2852660,2853947,-1,1287,obgE,51.592851592851595,
6214,gene,2853980,2854559,-1,579,spo0B,60.10362694300518,
6215,CDS,2853980,2854559,-1,579,spo0B,60.10362694300518,
6217,CDS,2854636,2854759,1,123,BSU_27935,63.41463414634146,
6216,gene,2854636,2854759,1,123,BSU_27935,63.41463414634146,
6219,CDS,2854879,2855164,-1,285,rpmA,55.08771929824562,
6218,gene,2854879,2855164,-1,285,rpmA,55.08771929824562,
6220,gene,2855176,2855515,-1,339,rppA,53.98230088495575,
6221,CDS,2855176,2855515,-1,339,rppA,53.98230088495575,
6222,gene,2855517,2855826,-1,309,rplU,59.8705501618123,
6223,CDS,2855517,2855826,-1,309,rplU,59.8705501618123,
6224,gene,2855839,2855915,-1,76,ldlU,52.63157894736842,
6225,misc_RNA,2855839,2855915,-1,76,ldlU,52.63157894736842,
6226,gene,2855972,2856839,-1,867,spoIVFB,54.55594002306805,
6227,CDS,2855972,2856839,-1,867,spoIVFB,54.55594002306805,
6228,gene,2856831,2857626,-1,795,spoIVFA,57.861635220125784,
6229,CDS,2856831,2857626,-1,795,spoIVFA,57.861635220125784,
6230,gene,2857775,2858582,-1,807,minD,55.26641883519206,
6231,CDS,2857775,2858582,-1,807,minD,55.26641883519206,
6232,gene,2858583,2859264,-1,681,minC,58.29662261380323,
6233,CDS,2858583,2859264,-1,681,minC,58.29662261380323,
6234,gene,2859316,2859835,-1,519,mreD,63.39113680154143,
6235,CDS,2859316,2859835,-1,519,mreD,63.39113680154143,
6236,gene,2859831,2860704,-1,873,mreC,57.61741122565864,
6237,CDS,2859831,2860704,-1,873,mreC,57.61741122565864,
6239,CDS,2860734,2861748,-1,1014,mreB,52.85996055226825,
6238,gene,2860734,2861748,-1,1014,mreB,52.85996055226825,
6240,gene,2861839,2862535,-1,696,ysxA,55.45977011494253,
6241,CDS,2861839,2862535,-1,696,ysxA,55.45977011494253,
6242,gene,2862571,2863141,-1,570,maf,56.315789473684205,
6243,CDS,2862571,2863141,-1,570,maf,56.315789473684205,
6244,gene,2863293,2864292,-1,999,spoIIB,55.65565565565566,
6245,CDS,2863293,2864292,-1,999,spoIIB,55.65565565565566,
6246,gene,2864425,2865172,-1,747,comC,54.75234270414994,
6247,CDS,2864425,2865172,-1,747,comC,54.75234270414994,
6248,gene,2865311,2866604,-1,1293,folC,56.148491879350345,
6249,CDS,2865311,2866604,-1,1293,folC,56.148491879350345,
6250,gene,2866663,2869306,-1,2643,valS,53.7646613696557,
6251,CDS,2866663,2869306,-1,2643,valS,53.7646613696557,
6253,misc_RNA,2869365,2869588,-1,223,tboV,56.05381165919282,
6252,gene,2869365,2869588,-1,223,tboV,56.05381165919282,
6255,CDS,2869753,2869945,1,192,yszA,58.854166666666664,
6254,gene,2869753,2869945,1,192,yszA,58.854166666666664,
6256,gene,2869963,2870989,-1,1026,cotN,57.407407407407405,
6257,CDS,2869963,2870989,-1,1026,cotN,57.407407407407405,
6258,gene,2871021,2872749,-1,1728,spoVID,55.844907407407405,
6259,CDS,2871021,2872749,-1,1728,spoVID,55.844907407407405,
6261,CDS,2872879,2874172,-1,1293,hemL,52.590873936581595,
6260,gene,2872879,2874172,-1,1293,hemL,52.590873936581595,
6263,CDS,2874201,2875176,-1,975,hemB,54.769230769230774,
6262,gene,2874201,2875176,-1,975,hemB,54.769230769230774,
6264,gene,2875172,2875961,-1,789,hemD,54.879594423320654,
6265,CDS,2875172,2875961,-1,789,hemD,54.879594423320654,
6266,gene,2875950,2876895,-1,945,hemC,54.285714285714285,
6267,CDS,2875950,2876895,-1,945,hemC,54.285714285714285,
6268,gene,2876927,2877758,-1,831,hemX,58.48375451263538,
6269,CDS,2876927,2877758,-1,831,hemX,58.48375451263538,
6271,CDS,2877765,2879133,-1,1368,hemA,56.0672514619883,
6270,gene,2877765,2879133,-1,1368,hemA,56.0672514619883,
6273,CDS,2879362,2879860,1,498,ysxD,60.040160642570285,
6272,gene,2879362,2879860,1,498,ysxD,60.040160642570285,
6274,gene,2879881,2880469,-1,588,engB,57.31292517006803,
6275,CDS,2879881,2880469,-1,588,engB,57.31292517006803,
6276,gene,2880465,2882790,-1,2325,lonA,55.26881720430108,
6277,CDS,2880465,2882790,-1,2325,lonA,55.26881720430108,
6279,CDS,2882970,2884629,-1,1659,lonB,53.58649789029536,
6278,gene,2882970,2884629,-1,1659,lonB,53.58649789029536,
6281,CDS,2884780,2886043,-1,1263,clpX,58.353127474267616,
6280,gene,2884780,2886043,-1,1263,clpX,58.353127474267616,
6282,gene,2886314,2887589,-1,1275,tig,58.58823529411765,
6283,CDS,2886314,2887589,-1,1275,tig,58.58823529411765,
6284,gene,2887816,2888821,-1,1005,ysoA,56.81592039800994,
6285,CDS,2887816,2888821,-1,1005,ysoA,56.81592039800994,
6286,gene,2888939,2889539,-1,600,leuD,58.333333333333336,
6287,CDS,2888939,2889539,-1,600,leuD,58.333333333333336,
6289,CDS,2889551,2890970,-1,1419,leuC,52.78365045806906,
6288,gene,2889551,2890970,-1,1419,leuC,52.78365045806906,
6291,CDS,2891019,2892117,-1,1098,leuB,53.36976320582878,
6290,gene,2891019,2892117,-1,1098,leuB,53.36976320582878,
6292,gene,2892137,2893694,-1,1557,leuA,55.55555555555556,
6293,CDS,2892137,2893694,-1,1557,leuA,55.55555555555556,
6294,gene,2893680,2894709,-1,1029,ilvC,55.68513119533528,
6295,CDS,2893680,2894709,-1,1029,ilvC,55.68513119533528,
6296,gene,2894732,2895251,-1,519,ilvH,57.996146435452786,
6297,CDS,2894732,2895251,-1,519,ilvH,57.996146435452786,
6298,gene,2895247,2896972,-1,1725,ilvB,52.69565217391305,
6299,CDS,2895247,2896972,-1,1725,ilvB,52.69565217391305,
6300,gene,2897093,2897340,-1,247,tboILV,51.821862348178136,
6301,misc_RNA,2897093,2897340,-1,247,tboILV,51.821862348178136,
6302,gene,2897787,2898123,1,336,cotQ,47.32142857142857,
6303,CDS,2897787,2898123,1,336,cotQ,47.32142857142857,
6304,gene,2898291,2898747,1,456,ysnE,55.92105263157895,
6305,CDS,2898291,2898747,1,456,ysnE,55.92105263157895,
6307,CDS,2898930,2899752,1,822,ysnF,59.36739659367397,
6306,gene,2898930,2899752,1,822,ysnF,59.36739659367397,
6309,tRNA,2899815,2899889,-1,74,trnSL-Arg2,40.54054054054054,
6308,gene,2899815,2899889,-1,74,trnSL-Arg2,40.54054054054054,
6310,gene,2900019,2900529,-1,510,ysnB,50.98039215686274,
6311,CDS,2900019,2900529,-1,510,ysnB,50.98039215686274,
6312,gene,2900544,2901141,-1,597,rdgB,56.28140703517588,
6313,CDS,2900544,2901141,-1,597,rdgB,56.28140703517588,
6315,CDS,2901153,2901891,-1,738,rph,53.387533875338754,
6314,gene,2901153,2901891,-1,738,rph,53.387533875338754,
6317,CDS,2902001,2903102,-1,1101,gerM,54.495912806539515,
6316,gene,2902001,2903102,-1,1101,gerM,54.495912806539515,
6318,gene,2903216,2904035,-1,819,rcmE,52.991452991452995,
6319,CDS,2903216,2904035,-1,819,rcmE,52.991452991452995,
6320,gene,2904042,2904483,-1,441,ysmB,56.68934240362812,
6321,CDS,2904042,2904483,-1,441,ysmB,56.68934240362812,
6323,CDS,2904726,2904951,-1,225,gerE,58.22222222222222,
6322,gene,2904726,2904951,-1,225,gerE,58.22222222222222,
6324,gene,2905066,2905510,-1,444,ysmA,56.75675675675676,
6325,CDS,2905066,2905510,-1,444,ysmA,56.75675675675676,
6327,CDS,2905570,2906332,-1,762,sdhB,53.41207349081365,
6326,gene,2905570,2906332,-1,762,sdhB,53.41207349081365,
6328,gene,2906334,2908095,-1,1761,sdhA,51.50482680295286,
6329,CDS,2906334,2908095,-1,1761,sdhA,51.50482680295286,
6330,gene,2908128,2908737,-1,609,sdhC,56.81444991789819,
6331,CDS,2908128,2908737,-1,609,sdhC,56.81444991789819,
6332,gene,2909029,2909476,1,447,yslB,57.71812080536913,
6333,CDS,2909029,2909476,1,447,yslB,57.71812080536913,
6335,CDS,2909519,2910746,-1,1227,lysCA,58.333333333333336,
6334,gene,2909519,2910746,-1,1227,lysCA,58.333333333333336,
6337,CDS,2909519,2910011,-1,492,lysCB,54.930725346373265,
6336,gene,2909519,2910011,-1,492,lysCB,54.930725346373265,
6338,gene,2910871,2911051,-1,180,kswC,55.55555555555556,
6339,misc_RNA,2910871,2911051,-1,180,kswC,55.55555555555556,
6340,gene,2911115,2912888,-1,1773,uvrC,54.653130287648054,
6341,CDS,2911115,2912888,-1,1773,uvrC,54.653130287648054,
6343,CDS,2913023,2913338,-1,315,trxA,57.460317460317455,
6342,gene,2913023,2913338,-1,315,trxA,57.460317460317455,
6345,misc_feature,2913482,2913593,-1,111,BSU_28509,63.06306306306306,
6344,gene,2913482,2913593,-1,111,BSU_28509,63.06306306306306,
6346,gene,2913660,2915148,-1,1488,abfB,52.82258064516129,
6347,CDS,2913660,2915148,-1,1488,abfB,52.82258064516129,
6348,gene,2915364,2916342,-1,978,etfA,51.63599182004091,
6349,CDS,2915364,2916342,-1,978,etfA,51.63599182004091,
6350,gene,2916377,2917151,-1,774,etfB,53.229974160206716,
6351,CDS,2916377,2917151,-1,774,etfB,53.229974160206716,
6352,gene,2917165,2917942,-1,777,fadB,51.48005148005148,
6353,CDS,2917165,2917942,-1,777,fadB,51.48005148005148,
6354,gene,2917956,2918541,-1,585,fadR,59.14529914529915,
6355,CDS,2917956,2918541,-1,585,fadR,59.14529914529915,
6356,gene,2918645,2920328,-1,1683,lcfA,54.129530600118834,
6357,CDS,2918645,2920328,-1,1683,lcfA,54.129530600118834,
6359,CDS,2920516,2920921,-1,405,yshE,55.80246913580247,
6358,gene,2920516,2920921,-1,405,yshE,55.80246913580247,
6361,CDS,2920935,2923293,-1,2358,mutSB,53.859202714164546,
6360,gene,2920935,2923293,-1,2358,mutSB,53.859202714164546,
6362,gene,2923313,2925026,-1,1713,polX,51.897256275539995,
6363,CDS,2923313,2925026,-1,1713,polX,51.897256275539995,
6364,gene,2925099,2925633,-1,534,yshB,56.17977528089888,
6365,CDS,2925099,2925633,-1,534,yshB,56.17977528089888,
6367,CDS,2925639,2925897,-1,258,zapA,61.240310077519375,
6366,gene,2925639,2925897,-1,258,zapA,61.240310077519375,
6369,CDS,2926030,2926972,1,942,rnhC,53.18471337579618,
6368,gene,2926030,2926972,1,942,rnhC,53.18471337579618,
6370,gene,2927007,2929422,-1,2415,pheT,53.12629399585921,
6371,CDS,2927007,2929422,-1,2415,pheT,53.12629399585921,
6372,gene,2929437,2930472,-1,1035,pheS,53.23671497584541,
6373,CDS,2929437,2930472,-1,1035,pheS,53.23671497584541,
6374,gene,2930553,2930760,1,207,BSU_28645,49.75845410628019,
6375,CDS,2930553,2930760,1,207,BSU_28645,49.75845410628019,
6377,CDS,2930826,2931573,-1,747,rlmBB,51.53949129852744,
6376,gene,2930826,2931573,-1,747,rlmBB,51.53949129852744,
6379,CDS,2931691,2931907,1,216,sspI,55.092592592592595,
6378,gene,2931691,2931907,1,216,sspI,55.092592592592595,
6381,CDS,2931975,2933082,1,1107,ysfB,54.83288166214996,
6380,gene,2931975,2933082,1,1107,ysfB,54.83288166214996,
6382,gene,2933184,2934597,1,1413,glcD,52.087756546355266,
6383,CDS,2933184,2934597,1,1413,glcD,52.087756546355266,
6384,gene,2934593,2935928,1,1335,glcF,51.38576779026217,
6385,CDS,2934593,2935928,1,1335,glcF,51.38576779026217,
6386,gene,2935966,2936209,-1,243,ysfE,52.2633744855967,
6387,CDS,2935966,2936209,-1,243,ysfE,52.2633744855967,
6389,CDS,2936268,2936439,-1,171,BSU_28709,57.89473684210527,
6388,gene,2936268,2936439,-1,171,BSU_28709,57.89473684210527,
6390,gene,2936381,2938178,-1,1797,cstA,51.140790205898725,
6391,CDS,2936381,2938178,-1,1797,cstA,51.140790205898725,
6392,gene,2938329,2939832,-1,1503,abfA,54.29141716566866,
6393,CDS,2938329,2939832,-1,1503,abfA,54.29141716566866,
6394,gene,2939850,2940696,-1,846,araQ,57.565011820330966,
6395,CDS,2939850,2940696,-1,846,araQ,57.565011820330966,
6396,gene,2940696,2941638,-1,942,araP,55.20169851380042,
6397,CDS,2940696,2941638,-1,942,araP,55.20169851380042,
6398,gene,2941673,2942975,-1,1302,araN,55.76036866359447,
6399,CDS,2941673,2942975,-1,1302,araN,55.76036866359447,
6400,gene,2943005,2944190,-1,1185,egsA,52.23628691983122,
6401,CDS,2943005,2944190,-1,1185,egsA,52.23628691983122,
6402,gene,2944186,2945005,-1,819,araL,50.91575091575091,
6403,CDS,2944186,2945005,-1,819,araL,50.91575091575091,
6405,CDS,2944982,2945672,-1,690,araD,54.637681159420296,
6404,gene,2944982,2945672,-1,690,araD,54.637681159420296,
6406,gene,2945688,2947371,-1,1683,araB,52.22816399286988,
6407,CDS,2945688,2947371,-1,1683,araB,52.22816399286988,
6408,gene,2947384,2948875,-1,1491,araA,52.38095238095239,
6409,CDS,2947384,2948875,-1,1491,araA,52.38095238095239,
6410,gene,2949052,2950024,-1,972,abnA,53.60082304526749,
6411,CDS,2949052,2950024,-1,972,abnA,53.60082304526749,
6412,gene,2950220,2951306,-1,1086,frvX,53.683241252302025,
6413,CDS,2950220,2951306,-1,1086,frvX,53.683241252302025,
6414,gene,2951489,2951882,1,393,ysdB,62.086513994910945,
6415,CDS,2951489,2951882,1,393,ysdB,62.086513994910945,
6416,gene,2951897,2952167,-1,270,ysdA,55.18518518518518,
6417,CDS,2951897,2952167,-1,270,ysdA,55.18518518518518,
6418,gene,2952223,2952583,-1,360,rplT,59.44444444444444,
6419,CDS,2952223,2952583,-1,360,rplT,59.44444444444444,
6420,gene,2952614,2952815,-1,201,rpmI,59.20398009950249,
6421,CDS,2952614,2952815,-1,201,rpmI,59.20398009950249,
6422,gene,2952827,2953349,-1,522,infC,56.13026819923371,
6423,CDS,2952827,2953349,-1,522,infC,56.13026819923371,
6424,gene,2953410,2953550,-1,140,BSU_misc_RNA_47,60.71428571428571,
6425,misc_RNA,2953410,2953550,-1,140,BSU_misc_RNA_47,60.71428571428571,
6426,gene,2953794,2954460,1,666,yscB,53.753753753753756,
6427,CDS,2953794,2954460,1,666,yscB,53.753753753753756,
6428,gene,2954491,2955187,-1,696,pftB,54.45402298850575,
6429,CDS,2954491,2955187,-1,696,pftB,54.45402298850575,
6430,gene,2955208,2955649,-1,441,pftA,58.27664399092971,
6431,CDS,2955208,2955649,-1,441,pftA,58.27664399092971,
6432,gene,2955782,2956508,-1,726,lytT,58.67768595041323,
6433,CDS,2955782,2956508,-1,726,lytT,58.67768595041323,
6434,gene,2956485,2958267,-1,1782,lytS,53.535353535353536,
6435,CDS,2956485,2958267,-1,1782,lytS,53.535353535353536,
6436,gene,2958433,2959216,1,783,ysaA,56.5772669220945,
6437,CDS,2958433,2959216,1,783,ysaA,56.5772669220945,
6438,gene,2959256,2961188,-1,1932,thrS,53.62318840579711,
6439,CDS,2959256,2961188,-1,1932,thrS,53.62318840579711,
6440,gene,2961231,2961479,-1,248,tboT,49.596774193548384,
6441,misc_RNA,2961231,2961479,-1,248,tboT,49.596774193548384,
6442,gene,2961585,2962431,-1,846,ytxC,57.21040189125296,
6443,CDS,2961585,2962431,-1,846,ytxC,57.21040189125296,
6444,gene,2962509,2963151,-1,642,ytxB,54.82866043613706,
6445,CDS,2962509,2963151,-1,642,ytxB,54.82866043613706,
6446,gene,2963184,2964120,-1,936,dnaI,56.94444444444444,
6447,CDS,2963184,2964120,-1,936,dnaI,56.94444444444444,
6448,gene,2964147,2965566,-1,1419,dnaB,54.756871035940804,
6449,CDS,2964147,2965566,-1,1419,dnaB,54.756871035940804,
6450,gene,2965680,2966139,-1,459,nrdR,53.812636165577345,
6451,CDS,2965680,2966139,-1,459,nrdR,53.812636165577345,
6452,gene,2966412,2966793,-1,381,speD,58.00524934383202,
6453,CDS,2966412,2966793,-1,381,speD,58.00524934383202,
6454,gene,2967031,2968054,-1,1023,gapB,54.252199413489734,
6455,CDS,2967031,2968054,-1,1023,gapB,54.252199413489734,
6456,gene,2968259,2968640,-1,381,ytcD,57.48031496062992,
6457,CDS,2968259,2968640,-1,381,ytcD,57.48031496062992,
6458,gene,2968823,2970014,1,1191,ytbD,52.47691015952981,
6459,CDS,2968823,2970014,1,1191,ytbD,52.47691015952981,
6460,gene,2970037,2970880,1,843,ytbE,55.99051008303677,
6461,CDS,2970037,2970880,1,843,ytbE,55.99051008303677,
6462,gene,2970921,2971515,-1,594,coaE,56.73400673400673,
6463,CDS,2970921,2971515,-1,594,coaE,56.73400673400673,
6464,gene,2971530,2972163,-1,633,spcF,56.872037914691944,
6465,CDS,2971530,2972163,-1,633,spcF,56.872037914691944,
6467,CDS,2972328,2973159,-1,831,mutM,52.82791817087846,
6466,gene,2972328,2973159,-1,831,mutM,52.82791817087846,
6469,CDS,2973181,2975824,-1,2643,polA,54.14301929625426,
6468,gene,2973181,2975824,-1,2643,polA,54.14301929625426,
6470,gene,2976067,2977807,-1,1740,phoR,54.71264367816092,
6471,CDS,2976067,2977807,-1,1740,phoR,54.71264367816092,
6472,gene,2977799,2978522,-1,723,phoP,57.81466113416322,
6473,CDS,2977799,2978522,-1,723,phoP,57.81466113416322,
6475,CDS,2978733,2979672,-1,939,mdh,54.84558040468583,
6474,gene,2978733,2979672,-1,939,mdh,54.84558040468583,
6477,CDS,2979715,2980987,-1,1272,icd,55.73899371069182,
6476,gene,2979715,2980987,-1,1272,icd,55.73899371069182,
6478,gene,2981150,2982269,-1,1119,citZ,53.61930294906166,
6479,CDS,2981150,2982269,-1,1119,citZ,53.61930294906166,
6480,gene,2982602,2983067,-1,465,ytwI,53.118279569892465,
6481,CDS,2982602,2983067,-1,465,ytwI,53.118279569892465,
6482,gene,2983163,2984279,1,1116,ytvI,55.376344086021504,
6483,CDS,2983163,2984279,1,1116,ytvI,55.376344086021504,
6484,gene,2984311,2984695,-1,384,ytzA,57.291666666666664,
6485,CDS,2984311,2984695,-1,384,ytzA,57.291666666666664,
6487,CDS,2984787,2986545,-1,1758,pyk,54.49374288964732,
6486,gene,2984787,2986545,-1,1758,pyk,54.49374288964732,
6488,gene,2986587,2987547,-1,960,pfkA,54.37499999999999,
6489,CDS,2986587,2987547,-1,960,pfkA,54.37499999999999,
6490,gene,2987730,2988708,-1,978,accA,54.396728016359916,
6491,CDS,2987730,2988708,-1,978,accA,54.396728016359916,
6493,CDS,2988692,2989565,-1,873,accD,56.1282932416953,
6492,gene,2988692,2989565,-1,873,accD,56.1282932416953,
6494,gene,2989899,2991132,-1,1233,maeB,54.09570154095702,
6495,CDS,2989899,2991132,-1,1233,maeB,54.09570154095702,
6497,CDS,2991268,2994616,-1,3348,dnaEC,53.91278375149343,
6496,gene,2991268,2994616,-1,3348,dnaEC,53.91278375149343,
6498,gene,2994755,2995097,1,342,ytrH,50.58479532163743,
6499,CDS,2994755,2995097,1,342,ytrH,50.58479532163743,
6500,gene,2995093,2995597,1,504,ytrI,60.912698412698404,
6501,CDS,2995093,2995597,1,504,ytrI,60.912698412698404,
6503,CDS,2995698,2995890,1,192,ytzJ,54.6875,
6502,gene,2995698,2995890,1,192,ytzJ,54.6875,
6505,CDS,2995907,2996849,-1,942,nrnA,55.095541401273884,
6504,gene,2995907,2996849,-1,942,nrnA,55.095541401273884,
6506,gene,2996979,2997282,1,303,ytpI,57.755775577557756,
6507,CDS,2996979,2997282,1,303,ytpI,57.755775577557756,
6508,gene,2997300,2998620,-1,1320,ytoI,53.86363636363637,
6509,CDS,2997300,2998620,-1,1320,ytoI,53.86363636363637,
6510,gene,2998795,2999698,-1,903,ytnM,55.48172757475083,
6511,CDS,2998795,2999698,-1,903,ytnM,55.48172757475083,
6512,gene,2999716,3000967,-1,1251,sndA,54.99600319744204,
6513,CDS,2999716,3000967,-1,1251,sndA,54.99600319744204,
6514,gene,3000984,3001677,-1,693,ribR,62.62626262626263,
6515,CDS,3000984,3001677,-1,693,ribR,62.62626262626263,
6516,gene,3001723,3003052,-1,1329,cmoJ,54.25131677953349,
6517,CDS,3001723,3003052,-1,1329,cmoJ,54.25131677953349,
6518,gene,3003048,3003330,-1,282,cmoI,58.51063829787234,
6519,CDS,3003048,3003330,-1,282,cmoI,58.51063829787234,
6520,gene,3003344,3004349,-1,1005,cmoO,53.233830845771145,
6521,CDS,3003344,3004349,-1,1005,cmoO,53.233830845771145,
6523,CDS,3004345,3005125,-1,780,tcyN,54.35897435897436,
6522,gene,3004345,3005125,-1,780,tcyN,54.35897435897436,
6524,gene,3005121,3005829,-1,708,tcyM,56.07344632768362,
6525,CDS,3005121,3005829,-1,708,tcyM,56.07344632768362,
6526,gene,3005858,3006578,-1,720,tcyL,56.25,
6527,CDS,3005858,3006578,-1,720,tcyL,56.25,
6528,gene,3006599,3007412,-1,813,tcyK,58.54858548585485,
6529,CDS,3006599,3007412,-1,813,tcyK,58.54858548585485,
6530,gene,3007425,3008235,-1,810,tcyJ,59.50617283950618,
6531,CDS,3007425,3008235,-1,810,tcyJ,59.50617283950618,
6533,CDS,3008248,3008785,-1,537,snaA,51.76908752327747,
6532,gene,3008248,3008785,-1,537,snaA,51.76908752327747,
6534,gene,3008937,3009864,1,927,ascR,57.17367853290184,
6535,CDS,3008937,3009864,1,927,ascR,57.17367853290184,
6536,gene,3009914,3010598,-1,684,ytkL,52.77777777777778,
6537,CDS,3009914,3010598,-1,684,ytkL,52.77777777777778,
6539,CDS,3010660,3011428,-1,768,ytkK,52.994791666666664,
6538,gene,3010660,3011428,-1,768,ytkK,52.994791666666664,
6541,CDS,3011554,3011791,-1,237,ytzD,59.49367088607595,
6540,gene,3011554,3011791,-1,237,ytzD,59.49367088607595,
6542,gene,3011750,3013136,-1,1386,argH,52.38095238095239,
6543,CDS,3011750,3013136,-1,1386,argH,52.38095238095239,
6544,gene,3013132,3014344,-1,1212,argG,52.97029702970298,
6545,CDS,3013132,3014344,-1,1212,argG,52.97029702970298,
6547,CDS,3014513,3015026,-1,513,moaB,52.63157894736842,
6546,gene,3014513,3015026,-1,513,moaB,52.63157894736842,
6548,gene,3015110,3016298,-1,1188,ackA,54.966329966329965,
6549,CDS,3015110,3016298,-1,1188,ackA,54.966329966329965,
6550,gene,3016470,3016674,-1,204,BSU_29479,63.725490196078425,
6551,CDS,3016470,3016674,-1,204,BSU_29479,63.725490196078425,
6552,gene,3016645,3017635,-1,990,ytxK,56.060606060606055,
6553,CDS,3016645,3017635,-1,990,ytxK,56.060606060606055,
6555,CDS,3017695,3018199,-1,504,tpx,55.55555555555556,
6554,gene,3017695,3018199,-1,504,tpx,55.55555555555556,
6557,CDS,3018308,3018764,-1,456,gerW,56.57894736842105,
6556,gene,3018308,3018764,-1,456,gerW,56.57894736842105,
6559,CDS,3018777,3019458,-1,681,ytfI,57.856093979442,
6558,gene,3018777,3019458,-1,681,ytfI,57.856093979442,
6560,gene,3019532,3020027,-1,495,yteJ,55.55555555555556,
6561,CDS,3019532,3020027,-1,495,yteJ,55.55555555555556,
6562,gene,3020039,3021047,-1,1008,sppA,55.654761904761905,
6563,CDS,3020039,3021047,-1,1008,sppA,55.654761904761905,
6564,gene,3021232,3022036,1,804,ppnKB,55.472636815920396,
6565,CDS,3021232,3022036,1,804,ppnKB,55.472636815920396,
6566,gene,3022067,3023657,-1,1590,ytcJ,51.0062893081761,
6567,CDS,3022067,3023657,-1,1590,ytcJ,51.0062893081761,
6568,gene,3023676,3025266,-1,1590,ytcI,55.283018867924525,
6569,CDS,3023676,3025266,-1,1590,ytcI,55.283018867924525,
6570,gene,3025444,3025654,-1,210,sspA,56.666666666666664,
6571,CDS,3025444,3025654,-1,210,sspA,56.666666666666664,
6572,gene,3025747,3026953,-1,1206,trmG,56.96517412935324,
6573,CDS,3025747,3026953,-1,1206,trmG,56.96517412935324,
6575,CDS,3026956,3028102,-1,1146,iscSB,55.32286212914486,
6574,gene,3026956,3028102,-1,1146,iscSB,55.32286212914486,
6577,CDS,3028296,3029634,1,1338,braB,57.473841554559044,
6576,gene,3028296,3029634,1,1338,braB,57.473841554559044,
6578,gene,3029728,3031417,-1,1689,ezrA,56.00947306098283,
6579,CDS,3029728,3031417,-1,1689,ezrA,56.00947306098283,
6580,gene,3031613,3032420,1,807,hisK,55.39033457249071,
6581,CDS,3031613,3032420,1,807,hisK,55.39033457249071,
6582,gene,3032416,3033040,-1,624,refZ,60.09615384615385,
6583,CDS,3032416,3033040,-1,624,refZ,60.09615384615385,
6584,gene,3033166,3033658,1,492,msrC,53.2520325203252,
6585,CDS,3033166,3033658,1,492,msrC,53.2520325203252,
6586,gene,3033695,3035435,-1,1740,dgcP,56.72413793103448,
6587,CDS,3033695,3035435,-1,1740,dgcP,56.72413793103448,
6588,gene,3035588,3035721,1,133,ldsD,61.65413533834586,
6589,misc_RNA,3035588,3035721,1,133,ldsD,61.65413533834586,
6591,CDS,3035729,3036332,1,603,rpsD,55.72139303482587,
6590,gene,3035729,3036332,1,603,rpsD,55.72139303482587,
6593,CDS,3036602,3037871,-1,1269,tyrS,55.71315996847912,
6592,gene,3036602,3037871,-1,1269,tyrS,55.71315996847912,
6595,misc_RNA,3037894,3038168,-1,274,tboY,57.299270072992705,
6594,gene,3037894,3038168,-1,274,tboY,57.299270072992705,
6596,gene,3038212,3039931,-1,1719,acsA,51.77428737638162,
6597,CDS,3038212,3039931,-1,1719,acsA,51.77428737638162,
6598,gene,3040091,3040724,1,633,acuA,53.396524486571884,
6599,CDS,3040091,3040724,1,633,acuA,53.396524486571884,
6600,gene,3040750,3041395,1,645,acuB,55.96899224806201,
6601,CDS,3040750,3041395,1,645,acuB,55.96899224806201,
6602,gene,3041391,3042555,1,1164,acuC,50.60137457044674,
6603,CDS,3041391,3042555,1,1164,acuC,50.60137457044674,
6604,gene,3042565,3043294,-1,729,motS,56.92729766803841,
6605,CDS,3042565,3043294,-1,729,motS,56.92729766803841,
6607,CDS,3043283,3044102,-1,819,motP,54.33455433455433,
6606,gene,3043283,3044102,-1,819,motP,54.33455433455433,
6608,gene,3044164,3045169,-1,1005,ccpA,53.830845771144276,
6609,CDS,3044164,3045169,-1,1005,ccpA,53.830845771144276,
6610,gene,3045444,3046521,-1,1077,aroX,54.68895078922934,
6611,CDS,3045444,3046521,-1,1077,aroX,54.68895078922934,
6613,CDS,3046756,3047083,-1,327,brxJ,55.35168195718655,
6612,gene,3046756,3047083,-1,327,brxJ,55.35168195718655,
6615,CDS,3047106,3047562,-1,456,ytxH,56.14035087719298,
6614,gene,3047106,3047562,-1,456,ytxH,56.14035087719298,
6616,gene,3047592,3048015,-1,423,ytxG,57.68321513002365,
6617,CDS,3047592,3048015,-1,423,ytxG,57.68321513002365,
6618,gene,3048176,3049475,-1,1299,murC,55.966127790608155,
6619,CDS,3048176,3049475,-1,1299,murC,55.966127790608155,
6621,CDS,3049724,3052583,-1,2859,sftA,52.74571528506471,
6620,gene,3049724,3052583,-1,2859,sftA,52.74571528506471,
6622,gene,3052742,3053348,-1,606,ytpR,55.775577557755774,
6623,CDS,3052742,3053348,-1,606,ytpR,55.775577557755774,
6625,CDS,3053363,3054173,-1,810,ytpQ,52.8395061728395,
6624,gene,3053363,3054173,-1,810,ytpQ,52.8395061728395,
6626,gene,3054187,3054511,-1,324,ytpP,59.876543209876544,
6627,CDS,3054187,3054511,-1,324,ytpP,59.876543209876544,
6629,CDS,3054549,3054666,-1,117,BSU_29845,66.66666666666666,
6628,gene,3054549,3054666,-1,117,BSU_29845,66.66666666666666,
6631,CDS,3054745,3055192,1,447,ytoQ,57.04697986577181,
6630,gene,3054745,3055192,1,447,ytoQ,57.04697986577181,
6633,CDS,3055246,3056320,-1,1074,ytoP,51.955307262569825,
6632,gene,3055246,3056320,-1,1074,ytoP,51.955307262569825,
6634,gene,3056478,3056796,1,318,ytzB,57.54716981132076,
6635,CDS,3056478,3056796,1,318,ytzB,57.54716981132076,
6636,gene,3056848,3058549,-1,1701,maeC,52.145796590241034,
6637,CDS,3056848,3058549,-1,1701,maeC,52.145796590241034,
6638,gene,3058630,3059401,-1,771,ytnP,54.08560311284047,
6639,CDS,3058630,3059401,-1,771,ytnP,54.08560311284047,
6641,CDS,3059546,3060188,-1,642,trmB,56.074766355140184,
6640,gene,3059546,3060188,-1,642,trmB,56.074766355140184,
6643,CDS,3060394,3060673,1,279,ytzH,57.70609318996416,
6642,gene,3060394,3060673,1,279,ytzH,57.70609318996416,
6644,gene,3060673,3061288,-1,615,ytmP,52.52032520325203,
6645,CDS,3060673,3061288,-1,615,ytmP,52.52032520325203,
6646,gene,3061650,3063807,-1,2157,amyX,52.29485396383866,
6647,CDS,3061650,3063807,-1,2157,amyX,52.29485396383866,
6649,CDS,3063832,3064762,-1,930,ytlR,55.80645161290323,
6648,gene,3063832,3064762,-1,930,ytlR,55.80645161290323,
6650,gene,3064810,3065725,-1,915,ytlQ,56.830601092896174,
6651,CDS,3064810,3065725,-1,915,ytlQ,56.830601092896174,
6652,gene,3065750,3066302,-1,552,ytlP,56.52173913043478,
6653,CDS,3065750,3066302,-1,552,ytlP,56.52173913043478,
6654,gene,3066450,3067386,1,936,ytkP,52.45726495726496,
6655,CDS,3066450,3067386,1,936,ytkP,52.45726495726496,
6656,gene,3067419,3068811,-1,1392,ytjP,52.1551724137931,
6657,CDS,3067419,3068811,-1,1392,ytjP,52.1551724137931,
6658,gene,3068907,3070206,1,1299,pbuO,51.50115473441108,
6659,CDS,3068907,3070206,1,1299,pbuO,51.50115473441108,
6661,CDS,3070245,3071403,-1,1158,ythQ,58.03108808290155,
6660,gene,3070245,3071403,-1,1158,ythQ,58.03108808290155,
6662,gene,3071399,3072110,-1,711,ythP,54.14908579465541,
6663,CDS,3071399,3072110,-1,711,ythP,54.14908579465541,
6665,CDS,3072400,3072622,1,222,ytzE,62.16216216216216,
6664,gene,3072400,3072622,1,222,ytzE,62.16216216216216,
6666,gene,3072742,3073462,-1,720,rsuA,51.388888888888886,
6667,CDS,3072742,3073462,-1,720,rsuA,51.388888888888886,
6668,gene,3073530,3075165,-1,1635,murJ,54.43425076452599,
6669,CDS,3073530,3075165,-1,1635,murJ,54.43425076452599,
6670,gene,3075366,3076629,1,1263,ytfP,53.20665083135392,
6671,CDS,3075366,3076629,1,1263,ytfP,53.20665083135392,
6672,gene,3076817,3078356,1,1539,opuD,54.8408057179987,
6673,CDS,3076817,3078356,1,1539,opuD,54.8408057179987,
6674,gene,3078392,3078575,-1,183,yteV,58.46994535519126,
6675,CDS,3078392,3078575,-1,183,yteV,58.46994535519126,
6677,CDS,3078642,3079311,-1,669,rmgU,53.064275037369214,
6676,gene,3078642,3079311,-1,669,rmgU,53.064275037369214,
6678,gene,3079332,3080619,-1,1287,rmgT,52.991452991452995,
6679,CDS,3079332,3080619,-1,1287,rmgT,52.991452991452995,
6681,CDS,3080630,3081134,-1,504,rmgS,56.34920634920635,
6680,gene,3080630,3081134,-1,504,rmgS,56.34920634920635,
6682,gene,3081130,3082252,-1,1122,rmgQ,52.85204991087345,
6683,CDS,3081130,3082252,-1,1122,rmgQ,52.85204991087345,
6685,CDS,3082259,3083225,-1,966,rmgP,55.38302277432712,
6684,gene,3082259,3083225,-1,966,rmgP,55.38302277432712,
6686,gene,3083440,3085759,1,2319,rmgR,56.23113410952997,
6687,CDS,3083440,3085759,1,2319,rmgR,56.23113410952997,
6689,CDS,3085799,3087296,-1,1497,ytcQ,54.04141616566466,
6688,gene,3085799,3087296,-1,1497,ytcQ,54.04141616566466,
6690,gene,3087320,3088181,-1,861,ytcP,56.09756097560976,
6691,CDS,3087320,3088181,-1,861,ytcP,56.09756097560976,
6692,gene,3088387,3089149,-1,762,ytbQ,54.59317585301837,
6693,CDS,3088387,3089149,-1,762,ytbQ,54.59317585301837,
6695,CDS,3089225,3090413,-1,1188,bioI,54.04040404040404,
6694,gene,3089225,3090413,-1,1188,bioI,54.04040404040404,
6696,gene,3090481,3091489,-1,1008,bioB,54.067460317460316,
6697,CDS,3090481,3091489,-1,1008,bioB,54.067460317460316,
6699,CDS,3091491,3092187,-1,696,bioD,55.74712643678161,
6698,gene,3091491,3092187,-1,696,bioD,55.74712643678161,
6700,gene,3092183,3093353,-1,1170,bioFC,53.07692307692308,
6701,CDS,3092183,3093353,-1,1170,bioFC,53.07692307692308,
6703,CDS,3093342,3094689,-1,1347,bioK,54.19450631031923,
6702,gene,3093342,3094689,-1,1347,bioK,54.19450631031923,
6704,gene,3094678,3095455,-1,777,bioW,56.113256113256114,
6705,CDS,3094678,3095455,-1,777,bioW,56.113256113256114,
6707,CDS,3095664,3096564,-1,900,ytaP,51.77777777777778,
6706,gene,3095664,3096564,-1,900,ytaP,51.77777777777778,
6708,gene,3096781,3097816,1,1035,msmR,51.01449275362319,
6709,CDS,3096781,3097816,1,1035,msmR,51.01449275362319,
6710,gene,3097849,3099130,1,1281,msmE,55.0351288056206,
6711,CDS,3097849,3099130,1,1281,msmE,55.0351288056206,
6713,CDS,3099122,3100034,1,912,msmF,54.49561403508771,
6712,gene,3099122,3100034,1,912,msmF,54.49561403508771,
6714,gene,3100030,3100861,1,831,msmG,55.47533092659447,
6715,CDS,3100030,3100861,1,831,msmG,55.47533092659447,
6717,CDS,3100880,3102179,1,1299,melA,55.042340261739795,
6716,gene,3100880,3102179,1,1299,melA,55.042340261739795,
6718,gene,3102200,3102512,-1,312,ytwF,57.05128205128205,
6719,CDS,3102200,3102512,-1,312,ytwF,57.05128205128205,
6720,gene,3102628,3105043,-1,2415,leuS,52.25672877846791,
6721,CDS,3102628,3105043,-1,2415,leuS,52.25672877846791,
6722,gene,3105152,3105367,-1,215,tboL,52.093023255813954,
6723,misc_RNA,3105152,3105367,-1,215,tboL,52.093023255813954,
6724,gene,3105469,3105805,-1,336,ytvB,53.57142857142857,
6725,CDS,3105469,3105805,-1,336,ytvB,53.57142857142857,
6726,gene,3106209,3106995,1,786,blrA,59.66921119592875,
6727,CDS,3106209,3106995,1,786,blrA,59.66921119592875,
6729,CDS,3107231,3108425,-1,1194,yttB,54.773869346733676,
6728,gene,3107231,3108425,-1,1194,yttB,54.773869346733676,
6731,CDS,3108613,3109360,1,747,yttA,59.17001338688086,
6730,gene,3108613,3109360,1,747,yttA,59.17001338688086,
6732,gene,3109396,3111337,-1,1941,bceB,58.62957238536837,
6733,CDS,3109396,3111337,-1,1941,bceB,58.62957238536837,
6735,CDS,3111326,3112088,-1,762,bceA,56.2992125984252,
6734,gene,3111326,3112088,-1,762,bceA,56.2992125984252,
6736,gene,3112189,3113194,-1,1005,bceS,57.611940298507456,
6737,CDS,3112189,3113194,-1,1005,bceS,57.611940298507456,
6738,gene,3113186,3113882,-1,696,bceR,54.59770114942529,
6739,CDS,3113186,3113882,-1,696,bceR,54.59770114942529,
6740,gene,3113978,3115289,-1,1311,ytrF,59.57284515636918,
6741,CDS,3113978,3115289,-1,1311,ytrF,59.57284515636918,metabolite permease involved in resistance to cell wall inhibitors
6742,gene,3115278,3115974,-1,696,ytrE,53.879310344827594,
6743,CDS,3115278,3115974,-1,696,ytrE,53.879310344827594,ABC transporter (ATP-binding protein) involved in resistance to cell wall inhibitors
6744,gene,3115988,3116966,-1,978,ytrD,59.40695296523517,
6745,CDS,3115988,3116966,-1,978,ytrD,59.40695296523517,"ABC transporter, permease component involved in resistance to cell wall inhibitors"
6747,CDS,3116995,3117982,-1,987,ytrC,59.979736575481255,"ABC transporter, permease component involved in resistance to cell wall inhibitors"
6746,gene,3116995,3117982,-1,987,ytrC,59.979736575481255,
6748,gene,3117975,3118854,-1,879,ytrB,55.8589306029579,
6749,CDS,3117975,3118854,-1,879,ytrB,55.8589306029579,ABC transporter (ATP-binding protein) involved in resistance to cell wall inhibitors
6751,CDS,3118846,3119239,-1,393,ytrA,57.25190839694656,"transcriptional regulator (GntR family, cell wall antibiotics)"
6750,gene,3118846,3119239,-1,393,ytrA,57.25190839694656,
6752,gene,3119272,3119410,-1,138,BSU_30466,67.3913043478261,
6753,CDS,3119272,3119410,-1,138,BSU_30466,67.3913043478261,
6755,CDS,3119564,3119837,-1,273,ytzC,59.70695970695971,
6754,gene,3119564,3119837,-1,273,ytzC,59.70695970695971,
6756,gene,3119998,3120967,1,969,ytqA,52.52837977296182,
6757,CDS,3119998,3120967,1,969,ytqA,52.52837977296182,
6759,CDS,3120963,3121548,1,585,ytqB,52.820512820512825,
6758,gene,3120963,3121548,1,585,ytqB,52.820512820512825,
6760,gene,3121537,3122641,-1,1104,tbcS,56.06884057971014,
6761,CDS,3121537,3122641,-1,1104,tbcS,56.06884057971014,
6762,gene,3122661,3123441,-1,780,ytpA,56.02564102564103,
6763,CDS,3122661,3123441,-1,780,ytpA,56.02564102564103,
6765,CDS,3123489,3124005,1,516,ytoA,53.48837209302325,
6764,gene,3123489,3124005,1,516,ytoA,53.48837209302325,
6767,CDS,3124249,3125641,-1,1392,ytnA,54.956896551724135,
6766,gene,3124249,3125641,-1,1392,ytnA,54.956896551724135,
6769,CDS,3125776,3127675,-1,1899,asnB,56.08214849921011,
6768,gene,3125776,3127675,-1,1899,asnB,56.08214849921011,
6770,gene,3127824,3129027,-1,1203,metK,54.03158769742311,
6771,CDS,3127824,3129027,-1,1203,metK,54.03158769742311,
6773,misc_RNA,3129194,3129333,-1,139,mswG,51.798561151079134,
6772,gene,3129194,3129333,-1,139,mswG,51.798561151079134,
6774,gene,3129529,3131113,1,1584,pckA,52.77777777777778,
6775,CDS,3129529,3131113,1,1584,pckA,52.77777777777778,
6776,gene,3131151,3131394,-1,243,ytmB,59.25925925925925,
6777,CDS,3131151,3131394,-1,243,ytmB,59.25925925925925,
6778,gene,3131445,3132219,-1,774,ytmA,52.32558139534884,
6779,CDS,3131445,3132219,-1,774,ytmA,52.32558139534884,
6780,gene,3132369,3133374,1,1005,ytlA,55.124378109452735,
6781,CDS,3132369,3133374,1,1005,ytlA,55.124378109452735,
6783,CDS,3133386,3134169,1,783,ytlC,55.30012771392082,
6782,gene,3133386,3134169,1,783,ytlC,55.30012771392082,
6785,CDS,3134143,3134956,1,813,ytlD,53.75153751537516,
6784,gene,3134143,3134956,1,813,ytlD,53.75153751537516,
6786,gene,3134982,3135459,-1,477,rppG,57.023060796645694,
6787,CDS,3134982,3135459,-1,477,rppG,57.023060796645694,
6788,gene,3135667,3136072,-1,405,ytkC,62.22222222222222,
6789,CDS,3135667,3136072,-1,405,ytkC,62.22222222222222,
6790,gene,3136237,3136675,-1,438,dps,60.04566210045662,
6791,CDS,3136237,3136675,-1,438,dps,60.04566210045662,
6793,CDS,3136767,3136944,1,177,ytzI,62.71186440677966,
6792,gene,3136767,3136944,1,177,ytzI,62.71186440677966,
6794,gene,3136937,3137375,-1,438,ytkA,56.16438356164384,
6795,CDS,3136937,3137375,-1,438,ytkA,56.16438356164384,
6796,gene,3137494,3137968,-1,474,luxS,56.540084388185655,
6797,CDS,3137494,3137968,-1,474,luxS,56.540084388185655,
6798,gene,3138096,3138324,1,228,ytjA,54.385964912280706,
6799,CDS,3138096,3138324,1,228,ytjA,54.385964912280706,
6800,gene,3138320,3138884,-1,564,ytiB,58.86524822695035,
6801,CDS,3138320,3138884,-1,564,ytiB,58.86524822695035,
6803,CDS,3138977,3139226,-1,249,rpmEB,58.23293172690763,
6802,gene,3138977,3139226,-1,249,rpmEB,58.23293172690763,
6804,gene,3139430,3140762,1,1332,ythA,52.702702702702695,
6805,CDS,3139430,3140762,1,1332,ythA,52.702702702702695,
6806,gene,3140805,3141846,1,1041,ythB,56.29202689721422,
6807,CDS,3140805,3141846,1,1041,ythB,56.29202689721422,
6808,gene,3141899,3142058,1,159,ytzL,57.23270440251572,
6809,CDS,3141899,3142058,1,159,ytzL,57.23270440251572,
6810,gene,3142076,3142964,-1,888,mntD,52.36486486486487,
6811,CDS,3142076,3142964,-1,888,mntD,52.36486486486487,
6812,gene,3142953,3144261,-1,1308,mntC,52.293577981651374,
6813,CDS,3142953,3144261,-1,1308,mntC,52.293577981651374,
6815,CDS,3144266,3145019,-1,753,mntB,51.92563081009296,
6814,gene,3144266,3145019,-1,753,mntB,51.92563081009296,
6816,gene,3145037,3145958,-1,921,mntA,54.18023887079262,
6817,CDS,3145037,3145958,-1,921,mntA,54.18023887079262,
6818,gene,3146237,3147353,-1,1116,menC,55.91397849462365,
6819,CDS,3146237,3147353,-1,1116,menC,55.91397849462365,
6821,CDS,3147349,3148810,-1,1461,menE,52.22450376454483,
6820,gene,3147349,3148810,-1,1461,menE,52.22450376454483,
6823,CDS,3148900,3149716,-1,816,menB,52.57352941176471,
6822,gene,3148900,3149716,-1,816,menB,52.57352941176471,
6824,gene,3149750,3150575,-1,825,menH,51.87878787878788,
6825,CDS,3149750,3150575,-1,825,menH,51.87878787878788,
6826,gene,3150562,3152305,-1,1743,menD,51.061388410786,
6827,CDS,3150562,3152305,-1,1743,menD,51.061388410786,
6829,CDS,3152301,3153717,-1,1416,menF,53.672316384180796,
6828,gene,3152301,3153717,-1,1416,menF,53.672316384180796,
6830,gene,3154006,3154726,1,720,yteA,55.13888888888889,
6831,CDS,3154006,3154726,1,720,yteA,55.13888888888889,
6832,gene,3154734,3155553,-1,819,ytdA,55.311355311355314,
6833,CDS,3154734,3155553,-1,819,ytdA,55.311355311355314,
6834,gene,3155724,3157011,1,1287,ytcA,53.379953379953385,
6835,CDS,3155724,3157011,1,1287,ytcA,53.379953379953385,
6836,gene,3157007,3157958,1,951,ytcB,53.20715036803365,
6837,CDS,3157007,3157958,1,951,ytcB,53.20715036803365,
6839,CDS,3157960,3159184,1,1224,ytcC,55.14705882352941,
6838,gene,3157960,3159184,1,1224,ytcC,55.14705882352941,
6841,CDS,3159257,3159689,-1,432,cotOO,55.32407407407407,
6840,gene,3159257,3159689,-1,432,cotOO,55.32407407407407,
6842,gene,3159690,3160746,-1,1056,cotS,56.91287878787878,
6843,CDS,3159690,3160746,-1,1056,cotS,56.91287878787878,
6844,gene,3160760,3161894,-1,1134,cotSA,53.70370370370371,
6845,CDS,3160760,3161894,-1,1134,cotSA,53.70370370370371,
6847,CDS,3162083,3163157,1,1074,cotI,56.424581005586596,
6846,gene,3162083,3163157,1,1074,cotI,56.424581005586596,
6849,CDS,3163236,3163704,1,468,ytaB,57.05128205128205,
6848,gene,3163236,3163704,1,468,ytaB,57.05128205128205,
6850,gene,3163734,3166131,-1,2397,glgP,55.444305381727155,
6851,CDS,3163734,3166131,-1,2397,glgP,55.444305381727155,
6852,gene,3166117,3167572,-1,1455,glgA,54.22680412371134,
6853,CDS,3166117,3167572,-1,1455,glgA,54.22680412371134,
6854,gene,3167568,3168600,-1,1032,glgD,54.55426356589147,
6855,CDS,3167568,3168600,-1,1032,glgD,54.55426356589147,
6857,CDS,3168623,3169766,-1,1143,glgC,56.517935258092734,
6856,gene,3168623,3169766,-1,1143,glgC,56.517935258092734,
6859,CDS,3169762,3171646,-1,1884,glgB,57.80254777070064,
6858,gene,3169762,3171646,-1,1884,glgB,57.80254777070064,
6860,gene,3171878,3171950,-1,72,trnB-Glu,38.88888888888889,
6861,tRNA,3171878,3171950,-1,72,trnB-Glu,38.88888888888889,
6862,gene,3171975,3172066,-1,91,trnB-Ser2,40.65934065934066,
6863,tRNA,3171975,3172066,-1,91,trnB-Ser2,40.65934065934066,
6864,gene,3172069,3172144,-1,75,trnB-Asn,44.0,
6865,tRNA,3172069,3172144,-1,75,trnB-Asn,44.0,
6866,gene,3172154,3172231,-1,77,trnB-Ile2,40.25974025974026,
6867,tRNA,3172154,3172231,-1,77,trnB-Ile2,40.25974025974026,
6868,gene,3172246,3172320,-1,74,trnB-Gly2,45.94594594594595,
6869,tRNA,3172246,3172320,-1,74,trnB-Gly2,45.94594594594595,
6870,gene,3172330,3172406,-1,76,trnB-His,43.42105263157895,
6871,tRNA,3172330,3172406,-1,76,trnB-His,43.42105263157895,
6873,tRNA,3172423,3172499,-1,76,trnB-Phe,40.78947368421053,
6872,gene,3172423,3172499,-1,76,trnB-Phe,40.78947368421053,
6874,gene,3172511,3172588,-1,77,trnB-Asp,36.36363636363637,
6875,tRNA,3172511,3172588,-1,77,trnB-Asp,36.36363636363637,
6877,tRNA,3172599,3172676,-1,77,trnB-Met2,36.36363636363637,
6876,gene,3172599,3172676,-1,77,trnB-Met2,36.36363636363637,
6878,gene,3172693,3172786,-1,93,trnB-Ser1,40.86021505376344,
6879,tRNA,3172693,3172786,-1,93,trnB-Ser1,40.86021505376344,
6880,gene,3172792,3172869,-1,77,trnB-Met3,45.45454545454545,
6881,tRNA,3172792,3172869,-1,77,trnB-Met3,45.45454545454545,
6882,gene,3172871,3172948,-1,77,trnB-Met1,35.064935064935064,
6883,tRNA,3172871,3172948,-1,77,trnB-Met1,35.064935064935064,
6884,gene,3172967,3173040,-1,73,trnB-Ala,34.24657534246575,
6885,tRNA,3172967,3173040,-1,73,trnB-Ala,34.24657534246575,
6886,gene,3173045,3173122,-1,77,trnB-Pro,42.857142857142854,
6887,tRNA,3173045,3173122,-1,77,trnB-Pro,42.857142857142854,
6888,gene,3173137,3173214,-1,77,trnB-Arg,42.857142857142854,
6889,tRNA,3173137,3173214,-1,77,trnB-Arg,42.857142857142854,
6891,tRNA,3173223,3173309,-1,86,trnB-Leu2,39.53488372093023,
6890,gene,3173223,3173309,-1,86,trnB-Leu2,39.53488372093023,
6892,gene,3173323,3173398,-1,75,trnB-Gly1,40.0,
6893,tRNA,3173323,3173398,-1,75,trnB-Gly1,40.0,
6895,tRNA,3173403,3173490,-1,87,trnB-Leu1,43.67816091954023,
6894,gene,3173403,3173490,-1,87,trnB-Leu1,43.67816091954023,
6896,gene,3173500,3173576,-1,76,trnB-Lys,51.31578947368421,
6897,tRNA,3173500,3173576,-1,76,trnB-Lys,51.31578947368421,
6899,tRNA,3173613,3173689,-1,76,trnB-Thr,47.368421052631575,
6898,gene,3173613,3173689,-1,76,trnB-Thr,47.368421052631575,
6900,gene,3173721,3173797,-1,76,trnB-Val,39.473684210526315,
6901,tRNA,3173721,3173797,-1,76,trnB-Val,39.473684210526315,
6903,rRNA,3173817,3173935,-1,118,rrnB-5S,42.3728813559322,
6902,gene,3173817,3173935,-1,118,rrnB-5S,42.3728813559322,
6904,gene,3173990,3176918,-1,2928,rrnB-23S,46.14071038251366,
6905,rRNA,3173990,3176918,-1,2928,rrnB-23S,46.14071038251366,
6906,gene,3177085,3178640,-1,1555,rrnB-16S,45.08038585209003,
6907,rRNA,3177085,3178640,-1,1555,rrnB-16S,45.08038585209003,
6909,misc_RNA,3179104,3179206,1,102,tswC,50.98039215686274,
6908,gene,3179104,3179206,1,102,tswC,50.98039215686274,
6911,CDS,3179305,3179884,1,579,thiT,58.03108808290155,
6910,gene,3179305,3179884,1,579,thiT,58.03108808290155,
6913,CDS,3179925,3180447,-1,522,yuaI,57.47126436781609,
6912,gene,3179925,3180447,-1,522,yuaI,57.47126436781609,
6914,gene,3180464,3181994,-1,1530,floT,56.1437908496732,
6915,CDS,3180464,3181994,-1,1530,floT,56.1437908496732,
6917,CDS,3182014,3182539,-1,525,nfeDB,57.52380952380952,
6916,gene,3182014,3182539,-1,525,nfeDB,57.52380952380952,
6918,gene,3182706,3183195,1,489,yuaE,58.282208588957054,
6919,CDS,3182706,3183195,1,489,yuaE,58.282208588957054,
6920,gene,3183200,3183779,-1,579,yuaD,53.1951640759931,
6921,CDS,3183200,3183779,-1,579,yuaD,53.1951640759931,
6923,CDS,3183866,3185075,-1,1209,gbsB,52.68817204301075,
6922,gene,3183866,3185075,-1,1209,gbsB,52.68817204301075,
6924,gene,3185091,3186564,-1,1473,gbsA,52.885268160217244,
6925,CDS,3185091,3186564,-1,1473,gbsA,52.885268160217244,
6927,CDS,3186762,3187305,1,543,gbsR,58.5635359116022,
6926,gene,3186762,3187305,1,543,gbsR,58.5635359116022,
6928,gene,3187502,3188048,1,546,bslA,56.776556776556774,
6929,CDS,3187502,3188048,1,546,bslA,56.776556776556774,
6931,misc_RNA,3188172,3188341,1,169,swdA,55.02958579881657,
6930,gene,3188172,3188341,1,169,swdA,55.02958579881657,
6932,gene,3188413,3189082,1,669,ktrA,57.69805680119582,
6933,CDS,3188413,3189082,1,669,ktrA,57.69805680119582,
6934,gene,3189088,3190426,1,1338,ktrB,56.80119581464873,
6935,CDS,3189088,3190426,1,1338,ktrB,56.80119581464873,
6936,gene,3190461,3190725,-1,264,yubF,62.5,
6937,CDS,3190461,3190725,-1,264,yubF,62.5,
6938,gene,3190833,3191682,-1,849,lytG,58.303886925795055,
6939,CDS,3190833,3191682,-1,849,lytG,58.303886925795055,
6940,gene,3191842,3193378,-1,1536,yubD,53.580729166666664,
6941,CDS,3191842,3193378,-1,1536,yubD,53.580729166666664,
6942,gene,3193862,3194348,1,486,cdoA,60.288065843621396,
6943,CDS,3193862,3194348,1,486,cdoA,60.288065843621396,
6945,tRNA,3194454,3194527,-1,73,trnSL-Ala1,32.87671232876712,
6944,gene,3194454,3194527,-1,73,trnSL-Ala1,32.87671232876712,
6947,CDS,3194634,3195465,-1,831,uppP,56.55836341756919,
6946,gene,3194634,3195465,-1,831,uppP,56.55836341756919,
6948,gene,3195557,3196724,-1,1167,yubA,59.297343616109686,
6949,CDS,3195557,3196724,-1,1167,yubA,59.297343616109686,
6950,gene,3196905,3197892,1,987,iolU,53.49544072948328,
6951,CDS,3196905,3197892,1,987,iolU,53.49544072948328,
6952,gene,3197932,3199207,-1,1275,rhaA,54.666666666666664,
6953,CDS,3197932,3199207,-1,1275,rhaA,54.666666666666664,
6954,gene,3199232,3199547,-1,315,rhaM,59.682539682539684,
6955,CDS,3199232,3199547,-1,315,rhaM,59.682539682539684,
6956,gene,3199564,3201022,-1,1458,rhaB,56.85871056241426,
6957,CDS,3199564,3201022,-1,1458,rhaB,56.85871056241426,
6958,gene,3201026,3201803,-1,777,rhaR,55.46975546975547,
6959,CDS,3201026,3201803,-1,777,rhaR,55.46975546975547,
6961,CDS,3201859,3203929,-1,2070,rhaE,52.70531400966184,
6960,gene,3201859,3203929,-1,2070,rhaE,52.70531400966184,
6963,CDS,3204066,3206055,-1,1989,tlpB,56.81246857717446,
6962,gene,3204066,3206055,-1,1989,tlpB,56.81246857717446,
6964,gene,3206168,3208154,-1,1986,mcpA,55.53877139979859,
6965,CDS,3206168,3208154,-1,1986,mcpA,55.53877139979859,
6966,gene,3208279,3210268,-1,1989,tlpA,55.75666163901458,
6967,CDS,3208279,3210268,-1,1989,tlpA,55.75666163901458,
6969,CDS,3210444,3212433,-1,1989,mcpB,55.203619909502265,
6968,gene,3210444,3212433,-1,1989,mcpB,55.203619909502265,
6971,CDS,3212590,3213328,1,738,tgl,58.13008130081301,
6970,gene,3212590,3213328,1,738,tgl,58.13008130081301,
6972,gene,3213341,3213596,-1,255,yuzH,60.0,
6973,CDS,3213341,3213596,-1,255,yuzH,60.0,
6974,gene,3213853,3214252,-1,399,yugU,52.63157894736842,
6975,CDS,3213853,3214252,-1,399,yugU,52.63157894736842,
6976,gene,3214211,3214346,-1,135,BSU_31289,62.22222222222222,
6977,CDS,3214211,3214346,-1,135,BSU_31289,62.22222222222222,
6979,CDS,3214371,3216036,-1,1665,yugT,56.3963963963964,
6978,gene,3214371,3216036,-1,1665,yugT,56.3963963963964,
6981,CDS,3216162,3217452,-1,1290,yugS,57.054263565891475,
6980,gene,3216162,3217452,-1,1290,yugS,57.054263565891475,
6982,gene,3217495,3218173,-1,678,yugP,54.424778761061944,
6983,CDS,3217495,3218173,-1,678,yugP,54.424778761061944,
6984,gene,3218214,3218478,-1,264,yuzI,58.71212121212122,
6985,CDS,3218214,3218478,-1,264,yuzI,58.71212121212122,
6987,CDS,3218524,3218857,1,333,mstX,60.66066066066066,
6986,gene,3218524,3218857,1,333,mstX,60.66066066066066,
6989,CDS,3218853,3219840,1,987,kbfO,54.20466058763931,
6988,gene,3218853,3219840,1,987,kbfO,54.20466058763931,
6990,gene,3219836,3220241,-1,405,yugN,51.85185185185185,
6991,CDS,3219836,3220241,-1,405,yugN,51.85185185185185,
6992,gene,3220300,3220672,-1,372,yugM,58.06451612903226,
6993,CDS,3220300,3220672,-1,372,yugM,58.06451612903226,
6994,gene,3220730,3222083,-1,1353,pgi,56.393200295639325,
6995,CDS,3220730,3222083,-1,1353,pgi,56.393200295639325,
6997,CDS,3222194,3223367,-1,1173,bdhK,55.754475703324815,
6996,gene,3222194,3223367,-1,1173,bdhK,55.754475703324815,
6999,CDS,3223470,3224634,-1,1164,bdhJ,54.46735395189003,
6998,gene,3223470,3224634,-1,1164,bdhJ,54.46735395189003,
7000,gene,3224863,3225100,1,237,yuzA,54.85232067510548,
7001,CDS,3224863,3225100,1,237,yuzA,54.85232067510548,
7002,gene,3225177,3225570,-1,393,yugI,60.30534351145038,
7003,CDS,3225177,3225570,-1,393,yugI,60.30534351145038,
7004,gene,3225771,3226932,-1,1161,yugH,52.540913006029285,
7005,CDS,3225771,3226932,-1,1161,yugH,52.540913006029285,
7006,gene,3226932,3227433,-1,501,yugG,57.08582834331337,
7007,CDS,3226932,3227433,-1,501,yugG,57.08582834331337,
7008,gene,3227580,3228402,1,822,yugF,54.98783454987834,
7009,CDS,3227580,3228402,1,822,yugF,54.98783454987834,
7010,gene,3228430,3228691,-1,261,yugE,54.406130268199234,
7011,CDS,3228430,3228691,-1,261,yugE,54.406130268199234,
7013,CDS,3228777,3229941,1,1164,patB,51.546391752577314,
7012,gene,3228777,3229941,1,1164,patB,51.546391752577314,
7015,CDS,3230066,3231353,1,1287,kinB,56.64335664335665,
7014,gene,3230066,3231353,1,1287,kinB,56.64335664335665,
7017,CDS,3231398,3231785,1,387,kapB,54.00516795865633,
7016,gene,3231398,3231785,1,387,kapB,54.00516795865633,
7018,gene,3231811,3232429,-1,618,kapD,58.7378640776699,
7019,CDS,3231811,3232429,-1,618,kapD,58.7378640776699,
7020,gene,3232639,3233818,1,1179,yuxJ,50.63613231552163,
7021,CDS,3232639,3233818,1,1179,yuxJ,50.63613231552163,
7022,gene,3233910,3235785,1,1875,pbpD,56.053333333333335,
7023,CDS,3233910,3235785,1,1875,pbpD,56.053333333333335,
7025,CDS,3235805,3236219,1,414,yuxK,55.072463768115945,
7024,gene,3235805,3236219,1,414,yuxK,55.072463768115945,
7026,gene,3236421,3236979,-1,558,yufK,61.469534050179206,
7027,CDS,3236421,3236979,-1,558,yufK,61.469534050179206,
7028,gene,3237156,3238758,1,1602,maeL,55.74282147315856,
7029,CDS,3237156,3238758,1,1602,maeL,55.74282147315856,
7031,CDS,3238750,3239458,1,708,maeM,59.18079096045198,
7030,gene,3238750,3239458,1,708,maeM,59.18079096045198,
7033,CDS,3239929,3241009,1,1080,nupN,54.629629629629626,
7032,gene,3239929,3241009,1,1080,nupN,54.629629629629626,
7035,CDS,3241084,3242617,1,1533,nupO,52.44618395303326,
7034,gene,3241084,3242617,1,1533,nupO,52.44618395303326,
7036,gene,3242609,3243656,1,1047,nupP,50.33428844317096,
7037,CDS,3242609,3243656,1,1047,nupP,50.33428844317096,
7039,CDS,3243656,3244616,1,960,nupQ,50.10416666666667,
7038,gene,3243656,3244616,1,960,nupQ,50.10416666666667,
7040,gene,3244769,3246116,1,1347,maeN,57.164068299925766,
7041,CDS,3244769,3246116,1,1347,maeN,57.164068299925766,
7042,gene,3246151,3246367,-1,216,yufS,52.77777777777778,
7043,CDS,3246151,3246367,-1,216,yufS,52.77777777777778,
7045,CDS,3246597,3249003,1,2406,mrpA,55.320033250207814,
7044,gene,3246597,3249003,1,2406,mrpA,55.320033250207814,
7046,gene,3248995,3249427,1,432,mrpB,55.32407407407407,
7047,CDS,3248995,3249427,1,432,mrpB,55.32407407407407,
7049,CDS,3249426,3249768,1,342,mrpC,56.4327485380117,
7048,gene,3249426,3249768,1,342,mrpC,56.4327485380117,
7050,gene,3249760,3251242,1,1482,mrpD,53.17139001349528,
7051,CDS,3249760,3251242,1,1482,mrpD,53.17139001349528,
7053,CDS,3251247,3251724,1,477,mrpE,60.58700209643606,
7052,gene,3251247,3251724,1,477,mrpE,60.58700209643606,
7054,gene,3251723,3252008,1,285,mrpF,55.08771929824562,
7055,CDS,3251723,3252008,1,285,mrpF,55.08771929824562,
7057,CDS,3251991,3252366,1,375,mrpG,55.2,
7056,gene,3251991,3252366,1,375,mrpG,55.2,
7058,gene,3252404,3252785,-1,381,yuxO,51.44356955380578,
7059,CDS,3252404,3252785,-1,381,yuxO,51.44356955380578,
7060,gene,3252803,3253448,-1,645,comA,58.44961240310077,
7061,CDS,3252803,3253448,-1,645,comA,58.44961240310077,
7062,gene,3253528,3255838,-1,2310,comP,65.06493506493507,
7063,CDS,3253528,3255838,-1,2310,comP,65.06493506493507,
7064,gene,3255852,3256020,-1,168,comX,69.64285714285714,
7065,CDS,3255852,3256020,-1,168,comX,69.64285714285714,
7067,CDS,3256007,3256907,-1,900,comQ,69.66666666666667,
7066,gene,3256007,3256907,-1,900,comQ,69.66666666666667,
7069,CDS,3257091,3257232,-1,141,degQ,70.92198581560284,
7068,gene,3257091,3257232,-1,141,degQ,70.92198581560284,
7070,gene,3257453,3257579,1,126,BSU_31725,64.28571428571429,
7071,CDS,3257453,3257579,1,126,BSU_31725,64.28571428571429,
7072,gene,3257692,3258061,1,369,cotIC,48.23848238482385,
7073,CDS,3257692,3258061,1,369,cotIC,48.23848238482385,
7074,gene,3258036,3259266,-1,1230,pdeH,59.512195121951216,
7075,CDS,3258036,3259266,-1,1230,pdeH,59.512195121951216,
7077,CDS,3259402,3260875,-1,1473,pncB,54.650373387644265,
7076,gene,3259402,3260875,-1,1473,pncB,54.650373387644265,
7078,gene,3260890,3261442,-1,552,pncA,57.065217391304344,
7079,CDS,3260890,3261442,-1,552,pncA,57.065217391304344,
7080,gene,3261538,3261937,-1,399,yueI,57.14285714285714,
7081,CDS,3261538,3261937,-1,399,yueI,57.14285714285714,
7082,gene,3262008,3262257,-1,249,yueH,53.41365461847389,
7083,CDS,3262008,3262257,-1,249,yueH,53.41365461847389,
7084,gene,3262329,3262551,-1,222,yueG,54.5045045045045,
7085,CDS,3262329,3262551,-1,222,yueG,54.5045045045045,
7087,CDS,3262610,3263720,-1,1110,yueF,56.57657657657658,
7086,gene,3262610,3263720,-1,1110,yueF,56.57657657657658,
7089,CDS,3263834,3264224,1,390,yuzE,54.35897435897436,
7088,gene,3263834,3264224,1,390,yuzE,54.35897435897436,
7090,gene,3264264,3264501,-1,237,yuzF,55.27426160337553,
7091,CDS,3264264,3264501,-1,237,yuzF,55.27426160337553,
7092,gene,3264677,3265208,-1,531,yueE,55.55555555555556,
7093,CDS,3264677,3265208,-1,531,yueE,55.55555555555556,
7094,gene,3265405,3266137,-1,732,bznD,54.23497267759563,
7095,CDS,3265405,3266137,-1,732,bznD,54.23497267759563,
7096,gene,3266199,3266655,-1,456,yueC,57.01754385964912,
7097,CDS,3266199,3266655,-1,456,yueC,57.01754385964912,
7098,gene,3266686,3269917,-1,3231,yueB,58.71247291860106,
7099,CDS,3266686,3269917,-1,3231,yueB,58.71247291860106,
7100,gene,3269913,3274401,-1,4488,yukAB,54.344919786096256,
7101,CDS,3269913,3274401,-1,4488,yukAB,54.344919786096256,
7103,CDS,3274461,3275817,-1,1356,yukC,59.070796460176986,
7102,gene,3274461,3275817,-1,1356,yukC,59.070796460176986,
7105,CDS,3275831,3276071,-1,240,yukD,57.49999999999999,
7104,gene,3275831,3276071,-1,240,yukD,57.49999999999999,
7106,gene,3276140,3276434,-1,294,yukE,57.48299319727891,
7107,CDS,3276140,3276434,-1,294,yukE,57.48299319727891,
7108,gene,3276954,3278223,1,1269,adeR,57.289204097714745,
7109,CDS,3276954,3278223,1,1269,adeR,57.289204097714745,
7111,CDS,3278324,3279461,1,1137,ald,50.30782761653474,
7110,gene,3278324,3279461,1,1137,ald,50.30782761653474,
7113,CDS,3279572,3280250,1,678,yukJ,56.63716814159292,
7112,gene,3279572,3280250,1,678,yukJ,56.63716814159292,
7114,gene,3280293,3280503,-1,210,mbtH,54.761904761904766,
7115,CDS,3280293,3280503,-1,210,mbtH,54.761904761904766,
7116,gene,3280518,3287655,-1,7137,dhbF,49.19433935827379,
7117,CDS,3280518,3287655,-1,7137,dhbF,49.19433935827379,
7118,gene,3287674,3288613,-1,939,dhbB,53.46112886048988,
7119,CDS,3287674,3288613,-1,939,dhbB,53.46112886048988,
7121,CDS,3288640,3290260,-1,1620,dhbE,49.629629629629626,
7120,gene,3288640,3290260,-1,1620,dhbE,49.629629629629626,
7123,CDS,3290288,3291485,-1,1197,dhbC,46.53299916457811,
7122,gene,3290288,3291485,-1,1197,dhbC,46.53299916457811,
7124,gene,3291510,3292296,-1,786,dhbA,50.0,
7125,CDS,3291510,3292296,-1,786,dhbA,50.0,
7126,gene,3292489,3293359,-1,870,besA,51.03448275862069,
7127,CDS,3292489,3293359,-1,870,besA,51.03448275862069,
7129,CDS,3293572,3294169,-1,597,yuiH,53.09882747068677,
7128,gene,3293572,3294169,-1,597,yuiH,53.09882747068677,
7131,CDS,3294269,3294872,1,603,bioYB,52.736318407960205,
7130,gene,3294269,3294872,1,603,bioYB,52.736318407960205,
7132,gene,3294941,3296270,-1,1329,hisP,52.746425884123404,
7133,CDS,3294941,3296270,-1,1329,hisP,52.746425884123404,
7134,gene,3296416,3297919,-1,1503,pepA,52.36194278110445,
7135,CDS,3296416,3297919,-1,1503,pepA,52.36194278110445,
7136,gene,3298076,3298553,1,477,yuiD,54.088050314465406,
7137,CDS,3298076,3298553,1,477,yuiD,54.088050314465406,
7139,CDS,3298583,3299240,-1,657,spsC,57.534246575342465,
7138,gene,3298583,3299240,-1,657,spsC,57.534246575342465,
7141,CDS,3299343,3299664,-1,321,yuiB,59.19003115264797,
7140,gene,3299343,3299664,-1,321,yuiB,59.19003115264797,
7142,gene,3299717,3299861,-1,144,yuiA,54.166666666666664,
7143,CDS,3299717,3299861,-1,144,yuiA,54.166666666666664,
7144,gene,3300033,3301254,-1,1221,yumB,51.515151515151516,
7145,CDS,3300033,3301254,-1,1221,yumB,51.515151515151516,
7146,gene,3301585,3302584,1,999,trxBB,52.552552552552555,
7147,CDS,3301585,3302584,1,999,trxBB,52.552552552552555,
7148,gene,3302622,3302763,-1,141,yuzG,59.57446808510638,
7149,CDS,3302622,3302763,-1,141,yuzG,59.57446808510638,
7150,gene,3303041,3304022,1,981,guaC,54.84199796126402,
7151,CDS,3303041,3304022,1,981,guaC,54.84199796126402,
7152,gene,3304095,3304719,-1,624,paiB,63.78205128205128,
7153,CDS,3304095,3304719,-1,624,paiB,63.78205128205128,
7154,gene,3304742,3305261,-1,519,paiA,64.9325626204239,
7155,CDS,3304742,3305261,-1,519,paiA,64.9325626204239,
7157,CDS,3305598,3305961,-1,363,sufA,51.790633608815426,
7156,gene,3305598,3305961,-1,363,sufA,51.790633608815426,
7159,CDS,3306039,3306894,-1,855,dapF,53.216374269005854,
7158,gene,3306039,3306894,-1,855,dapF,53.216374269005854,
7160,gene,3307016,3308231,-1,1215,yutK,53.00411522633745,
7161,CDS,3307016,3308231,-1,1215,yutK,53.00411522633745,
7162,gene,3308367,3308604,-1,237,yuzB,56.118143459915615,
7163,CDS,3308367,3308604,-1,237,yuzB,56.118143459915615,
7165,CDS,3308866,3309934,1,1068,yutJ,51.96629213483146,
7164,gene,3308866,3309934,1,1068,yutJ,51.96629213483146,
7167,CDS,3309959,3310286,-1,327,yuzD,56.88073394495413,
7166,gene,3309959,3310286,-1,327,yuzD,56.88073394495413,
7168,gene,3310385,3310721,1,336,yutI,57.14285714285714,
7169,CDS,3310385,3310721,1,336,yutI,57.14285714285714,
7170,gene,3310762,3312736,-1,1974,yuxL,51.57041540020263,
7171,CDS,3310762,3312736,-1,1974,yuxL,51.57041540020263,
7173,CDS,3312843,3313773,-1,930,thrB,48.924731182795696,
7172,gene,3312843,3313773,-1,930,thrB,48.924731182795696,
7174,gene,3313769,3314828,-1,1059,thrC,51.74693106704438,
7175,CDS,3313769,3314828,-1,1059,thrC,51.74693106704438,
7177,CDS,3314827,3316129,-1,1302,hom,53.45622119815668,
7176,gene,3314827,3316129,-1,1302,hom,53.45622119815668,
7178,gene,3316329,3317349,-1,1020,cotNH,55.392156862745104,
7179,CDS,3316329,3317349,-1,1020,cotNH,55.392156862745104,
7180,gene,3317501,3318002,1,501,yutG,55.489021956087825,
7181,CDS,3317501,3318002,1,501,yutG,55.489021956087825,
7182,gene,3318028,3318799,-1,771,nucF,51.75097276264592,
7183,CDS,3318028,3318799,-1,771,nucF,51.75097276264592,
7185,CDS,3318827,3319262,-1,435,yutE,54.71264367816092,
7184,gene,3318827,3319262,-1,435,yutE,54.71264367816092,
7187,CDS,3319285,3319561,-1,276,yutD,61.95652173913043,
7186,gene,3319285,3319561,-1,276,yutD,61.95652173913043,
7188,gene,3319675,3320308,1,633,yutC,52.922590837282776,
7189,CDS,3319675,3320308,1,633,yutC,52.922590837282776,
7190,gene,3320323,3321220,-1,897,lipA,53.28874024526199,
7191,CDS,3320323,3321220,-1,897,lipA,53.28874024526199,
7193,CDS,3321454,3322435,1,981,lytH,51.274209989806316,
7192,gene,3321454,3322435,1,981,lytH,51.274209989806316,
7195,CDS,3322462,3323227,-1,765,fisB,55.81699346405229,
7194,gene,3322462,3323227,-1,765,fisB,55.81699346405229,
7196,gene,3323299,3323605,-1,306,yunC,50.326797385620914,
7197,CDS,3323299,3323605,-1,306,yunC,50.326797385620914,
7198,gene,3323669,3325058,-1,1389,yunD,52.55579553635709,
7199,CDS,3323669,3325058,-1,1389,yunD,52.55579553635709,
7200,gene,3325077,3325899,-1,822,yunE,53.406326034063255,
7201,CDS,3325077,3325899,-1,822,yunE,53.406326034063255,
7202,gene,3325916,3326765,-1,849,yunF,51.001177856301524,
7203,CDS,3325916,3326765,-1,849,yunF,51.001177856301524,
7204,gene,3326802,3327150,-1,348,yunG,53.735632183908045,
7205,CDS,3326802,3327150,-1,348,yunG,53.735632183908045,
7206,gene,3327246,3328587,-1,1341,pucH,48.769574944071586,
7207,CDS,3327246,3328587,-1,1341,pucH,48.769574944071586,
7209,CDS,3328761,3330357,1,1596,pucR,53.383458646616546,
7208,gene,3328761,3330357,1,1596,pucR,53.383458646616546,
7211,CDS,3330501,3331851,1,1350,pucJ,49.48148148148148,
7210,gene,3330501,3331851,1,1350,pucJ,49.48148148148148,
7212,gene,3331856,3333149,1,1293,pucK,48.49187935034803,
7213,CDS,3331856,3333149,1,1293,pucK,48.49187935034803,
7214,gene,3333161,3334646,1,1485,pucL,52.053872053872055,
7215,CDS,3333161,3334646,1,1485,pucL,52.053872053872055,
7217,CDS,3334645,3334990,1,345,pucM,53.62318840579711,
7216,gene,3334645,3334990,1,345,pucM,53.62318840579711,
7219,gene,3335413,3335545,-1,132,auzJ,59.84848484848485,
7218,gene,3335413,3335545,1,132,yuzJ,59.84848484848485,
7220,ncRNA,3335413,3335545,-1,132,auzJ,59.84848484848485,
7221,CDS,3335413,3335545,1,132,yuzJ,59.84848484848485,
7222,gene,3335750,3336272,-1,522,pucE,47.701149425287355,
7223,CDS,3335750,3336272,-1,522,pucE,47.701149425287355,
7224,gene,3336262,3338500,-1,2238,pucD,48.704200178731014,
7225,CDS,3336262,3338500,-1,2238,pucD,48.704200178731014,
7227,CDS,3338500,3339334,-1,834,pucC,47.24220623501199,
7226,gene,3338500,3339334,-1,834,pucC,47.24220623501199,
7228,gene,3339330,3339948,-1,618,pucB,47.0873786407767,
7229,CDS,3339330,3339948,-1,618,pucB,47.0873786407767,
7231,CDS,3339944,3340937,-1,993,pucA,51.46022155085599,
7230,gene,3339944,3340937,-1,993,pucA,51.46022155085599,
7232,gene,3341165,3342416,-1,1251,pucG,47.8017585931255,
7233,CDS,3341165,3342416,-1,1251,pucG,47.8017585931255,
7234,gene,3342432,3343671,-1,1239,pucF,48.991121872477805,
7235,CDS,3342432,3343671,-1,1239,pucF,48.991121872477805,
7236,gene,3343893,3344031,1,138,BSU_32539,54.347826086956516,
7237,CDS,3343893,3344031,1,138,BSU_32539,54.347826086956516,
7238,gene,3344112,3344979,1,867,bsnA,50.17301038062284,
7239,CDS,3344112,3344979,1,867,bsnA,50.17301038062284,
7240,gene,3345012,3346116,-1,1104,frlP,52.53623188405797,
7241,CDS,3345012,3346116,-1,1104,frlP,52.53623188405797,
7242,gene,3346297,3347026,1,729,frlR,56.65294924554184,
7243,CDS,3346297,3347026,1,729,frlR,56.65294924554184,
7244,gene,3347050,3347905,-1,855,frlD,50.4093567251462,
7245,CDS,3347050,3347905,-1,855,frlD,50.4093567251462,
7247,CDS,3347918,3348821,-1,903,frlM,54.48504983388705,
7246,gene,3347918,3348821,-1,903,frlM,54.48504983388705,
7249,CDS,3348824,3349703,-1,879,frlN,55.745164960182024,
7248,gene,3348824,3349703,-1,879,frlN,55.745164960182024,
7250,gene,3349760,3351029,-1,1269,frlO,56.18597320724981,
7251,CDS,3349760,3351029,-1,1269,frlO,56.18597320724981,
7252,gene,3351109,3352096,-1,987,frlB,55.82573454913881,
7253,CDS,3351109,3352096,-1,987,frlB,55.82573454913881,
7255,CDS,3352311,3352686,-1,375,yurQ,62.4,
7254,gene,3352311,3352686,-1,375,yurQ,62.4,
7257,CDS,3352788,3353907,-1,1119,dadA,47.63181411974978,
7256,gene,3352788,3353907,-1,1119,dadA,47.63181411974978,
7258,gene,3354065,3354212,1,147,sspG,51.70068027210885,
7259,CDS,3354065,3354212,1,147,sspG,51.70068027210885,
7260,gene,3354211,3354487,1,276,yurS,62.68115942028986,
7261,CDS,3354211,3354487,1,276,yurS,62.68115942028986,
7263,CDS,3354550,3354934,-1,384,glxB,58.072916666666664,
7262,gene,3354550,3354934,-1,384,glxB,58.072916666666664,
7264,gene,3355044,3355323,-1,279,yuzN,59.49820788530465,
7265,CDS,3355044,3355323,-1,279,yuzN,59.49820788530465,
7267,CDS,3355592,3356990,-1,1398,sufB,55.93705293276109,
7266,gene,3355592,3356990,-1,1398,sufB,55.93705293276109,
7268,gene,3357010,3357454,-1,444,sufU,56.981981981981974,
7269,CDS,3357010,3357454,-1,444,sufU,56.981981981981974,
7270,gene,3357443,3358664,-1,1221,sufS,51.92465192465192,
7271,CDS,3357443,3358664,-1,1221,sufS,51.92465192465192,
7272,gene,3358663,3359977,-1,1314,sufD,53.88127853881278,
7273,CDS,3358663,3359977,-1,1314,sufD,53.88127853881278,
7275,CDS,3359994,3360780,-1,786,sufC,54.58015267175572,
7274,gene,3359994,3360780,-1,786,sufC,54.58015267175572,
7277,misc_RNA,3360936,3361184,-1,248,bsrI,57.25806451612904,
7276,gene,3360936,3361184,-1,248,bsrI,57.25806451612904,
7278,gene,3360973,3361111,-1,138,yuzK,53.62318840579711,
7279,CDS,3360973,3361111,-1,138,yuzK,53.62318840579711,
7280,gene,3361304,3361682,-1,378,yurZ,54.761904761904766,
7281,CDS,3361304,3361682,-1,378,yurZ,54.761904761904766,
7283,CDS,3361766,3362591,-1,825,metQ,60.84848484848485,
7282,gene,3361766,3362591,-1,825,metQ,60.84848484848485,
7285,CDS,3362604,3363273,-1,669,metP,57.847533632286996,
7284,gene,3362604,3363273,-1,669,metP,57.847533632286996,
7286,gene,3363265,3364291,-1,1026,metN,55.7504873294347,
7287,CDS,3363265,3364291,-1,1026,metN,55.7504873294347,
7288,gene,3364396,3364503,-1,107,mswH,51.4018691588785,
7289,misc_RNA,3364396,3364503,-1,107,mswH,51.4018691588785,
7290,gene,3364617,3364962,-1,345,yusD,58.84057971014492,
7291,CDS,3364617,3364962,-1,345,yusD,58.84057971014492,
7292,gene,3365068,3365389,-1,321,yusE,60.12461059190031,
7293,CDS,3365068,3365389,-1,321,yusE,60.12461059190031,
7294,gene,3365390,3365831,-1,441,yusF,56.235827664399096,
7295,CDS,3365390,3365831,-1,441,yusF,56.235827664399096,
7296,gene,3365830,3366067,-1,237,yusG,58.22784810126582,
7297,CDS,3365830,3366067,-1,237,yusG,58.22784810126582,
7299,CDS,3366122,3366506,-1,384,gcvH,54.947916666666664,
7298,gene,3366122,3366506,-1,384,gcvH,54.947916666666664,
7301,CDS,3366572,3366929,-1,357,yusI,57.14285714285714,
7300,gene,3366572,3366929,-1,357,yusI,57.14285714285714,
7302,gene,3367039,3368824,-1,1785,fadE,52.49299719887956,
7303,CDS,3367039,3368824,-1,1785,fadE,52.49299719887956,
7304,gene,3368838,3370014,-1,1176,fadA,47.44897959183674,
7305,CDS,3368838,3370014,-1,1176,fadA,47.44897959183674,
7306,gene,3370024,3372394,-1,2370,fadN,52.151898734177216,
7307,CDS,3370024,3372394,-1,2370,fadN,52.151898734177216,
7308,gene,3372568,3372715,1,147,yuzL,51.70068027210885,
7309,CDS,3372568,3372715,1,147,yuzL,51.70068027210885,
7310,gene,3372739,3373648,-1,909,putM,55.00550055005501,
7311,CDS,3372739,3373648,-1,909,putM,55.00550055005501,
7312,gene,3373742,3373988,1,246,yuzM,54.0650406504065,
7313,CDS,3373742,3373988,1,246,yuzM,54.0650406504065,
7315,CDS,3374000,3374333,1,333,yusN,59.45945945945946,
7314,gene,3374000,3374333,1,333,yusN,59.45945945945946,
7317,CDS,3374491,3374959,1,468,mdtR,52.35042735042735,
7316,gene,3374491,3374959,1,468,mdtR,52.35042735042735,
7318,gene,3374955,3376581,1,1626,mdtP,55.227552275522754,
7319,CDS,3374955,3376581,1,1626,mdtP,55.227552275522754,
7320,gene,3376616,3377000,-1,384,yusQ,59.895833333333336,
7321,CDS,3376616,3377000,-1,384,yusQ,59.895833333333336,
7323,CDS,3377018,3377408,-1,390,yusR,49.743589743589745,
7322,gene,3377018,3377408,-1,390,yusR,49.743589743589745,
7325,CDS,3377429,3377759,-1,330,yusS,51.515151515151516,
7324,gene,3377429,3377759,-1,330,yusS,51.515151515151516,
7326,gene,3377892,3378780,1,888,yusT,52.36486486486487,
7327,CDS,3377892,3378780,1,888,yusT,52.36486486486487,
7328,gene,3378799,3379087,-1,288,yusU,57.986111111111114,
7329,CDS,3378799,3379087,-1,288,yusU,57.986111111111114,
7330,gene,3379111,3379939,-1,828,feuV,51.328502415458935,
7331,CDS,3379111,3379939,-1,828,feuV,51.328502415458935,
7333,CDS,3380156,3380594,-1,438,cotNW,54.337899543378995,
7332,gene,3380156,3380594,-1,438,cotNW,54.337899543378995,
7335,misc_feature,3380703,3382212,-1,1509,yusYc,52.683896620278325,
7334,gene,3380703,3382212,-1,1509,yusYc,52.683896620278325,
7336,gene,3382208,3382499,-1,291,yusYn,50.51546391752577,
7337,misc_feature,3382208,3382499,-1,291,yusYn,50.51546391752577,
7338,gene,3382632,3383475,1,843,yusZ,53.855278766310796,
7339,CDS,3382632,3383475,1,843,yusZ,53.855278766310796,
7341,CDS,3383564,3384026,1,462,mrgA,58.44155844155844,
7340,gene,3383564,3384026,1,462,mrgA,58.44155844155844,
7343,CDS,3384069,3385446,-1,1377,htrB,52.723311546840954,
7342,gene,3384069,3385446,-1,1377,htrB,52.723311546840954,
7344,gene,3385723,3386401,1,678,cssR,54.27728613569322,
7345,CDS,3385723,3386401,1,678,cssR,54.27728613569322,
7346,gene,3386397,3387753,1,1356,cssS,58.62831858407079,
7347,CDS,3386397,3387753,1,1356,cssS,58.62831858407079,
7348,gene,3387780,3387945,-1,165,spxO,60.60606060606061,
7349,CDS,3387780,3387945,-1,165,spxO,60.60606060606061,
7351,CDS,3388112,3388988,1,876,yuxN,60.15981735159818,
7350,gene,3388112,3388988,1,876,yuxN,60.15981735159818,
7353,CDS,3389023,3390412,-1,1389,fumC,52.339812814974806,
7352,gene,3389023,3390412,-1,1389,fumC,52.339812814974806,
7354,gene,3390478,3390664,-1,186,yvzF,65.05376344086021,
7355,CDS,3390478,3390664,-1,186,yvzF,65.05376344086021,
7356,gene,3390781,3392230,1,1449,gerAA,55.83160800552105,
7357,CDS,3390781,3392230,1,1449,gerAA,55.83160800552105,
7358,gene,3392198,3393296,1,1098,gerAB,59.47176684881603,
7359,CDS,3392198,3393296,1,1098,gerAB,59.47176684881603,
7360,gene,3393292,3394414,1,1122,gerAC,57.308377896613194,
7361,CDS,3393292,3394414,1,1122,gerAC,57.308377896613194,
7362,gene,3394421,3395057,-1,636,liaR,51.257861635220124,
7363,CDS,3394421,3395057,-1,636,liaR,51.257861635220124,two-component response regulator [YvqE] responding to cell wall stress
7364,gene,3395034,3396117,-1,1083,liaS,52.53924284395198,
7365,CDS,3395034,3396117,-1,1083,liaS,52.53924284395198,two-component sensor histidine kinase [LiaR(YvqC)] sensing cell wall stress
7366,gene,3396113,3396839,-1,726,liaF,58.26446280991735,
7367,CDS,3396113,3396839,-1,726,liaF,58.26446280991735,
7368,gene,3396872,3397745,-1,873,liaG,53.15005727376862,
7369,CDS,3396872,3397745,-1,873,liaG,53.15005727376862,sensor of antibiotic stress on the cell wall
7370,gene,3397845,3398523,-1,678,liaH,57.52212389380531,
7371,CDS,3397845,3398523,-1,678,liaH,57.52212389380531,
7373,CDS,3398549,3398930,-1,381,liaI,54.59317585301837,
7372,gene,3398549,3398930,-1,381,liaI,54.59317585301837,
7374,gene,3399091,3400360,-1,1269,yvqJ,55.00394011032309,
7375,CDS,3399091,3400360,-1,1269,yvqJ,55.00394011032309,
7376,gene,3400536,3401118,-1,582,yvqK,50.687285223367695,
7377,CDS,3400536,3401118,-1,582,yvqK,50.687285223367695,
7378,gene,3401140,3402469,-1,1329,yvrA,51.09104589917231,
7379,CDS,3401140,3402469,-1,1329,yvrA,51.09104589917231,
7380,gene,3402468,3403530,-1,1062,yvrB,51.31826741996234,
7381,CDS,3402468,3403530,-1,1062,yvrB,51.31826741996234,
7382,gene,3403492,3404437,-1,945,yvrC,55.23809523809524,
7383,CDS,3403492,3404437,-1,945,yvrC,55.23809523809524,
7384,gene,3404545,3404676,-1,131,srbL,44.274809160305345,
7385,misc_RNA,3404545,3404676,-1,131,srbL,44.274809160305345,
7387,CDS,3404834,3405626,1,792,yvrD,51.13636363636363,
7386,gene,3404834,3405626,1,792,yvrD,51.13636363636363,
7389,CDS,3405663,3406542,-1,879,yvrE,51.990898748577926,
7388,gene,3405663,3406542,-1,879,yvrE,51.990898748577926,
7390,gene,3406613,3408356,-1,1743,yvrG,57.6592082616179,
7391,CDS,3406613,3408356,-1,1743,yvrG,57.6592082616179,two-component sensor histidine kinase YvrG [cell wall processes and sublancin production and immunity (YvrH)]
7392,gene,3408352,3409066,-1,714,yvrH,54.20168067226891,
7393,CDS,3408352,3409066,-1,714,yvrH,54.20168067226891,two-component sensor histidine kinase YvrG [cell wall processes and sublancin production and immunity (YvrG)]
7395,CDS,3409218,3409458,-1,240,rsoA,62.083333333333336,
7394,gene,3409218,3409458,-1,240,rsoA,62.083333333333336,
7397,CDS,3409461,3409992,-1,531,sigO,57.6271186440678,
7396,gene,3409461,3409992,-1,531,sigO,57.6271186440678,
7398,gene,3410006,3410345,1,339,yvrJ,62.53687315634219,
7399,CDS,3410006,3410345,1,339,yvrJ,62.53687315634219,
7400,gene,3410465,3411623,1,1158,oxdC,54.83592400690846,
7401,CDS,3410465,3411623,1,1158,oxdC,54.83592400690846,
7402,gene,3411683,3412094,1,411,rsiO,55.961070559610704,
7403,CDS,3411683,3412094,1,411,rsiO,55.961070559610704,
7405,CDS,3412127,3413357,-1,1230,yvrN,52.76422764227642,
7404,gene,3412127,3413357,-1,1230,yvrN,52.76422764227642,
7407,CDS,3413349,3414039,-1,690,yvrO,53.47826086956522,
7406,gene,3413349,3414039,-1,690,yvrO,53.47826086956522,
7408,gene,3414022,3415216,-1,1194,yvrP,54.773869346733676,
7409,CDS,3414022,3415216,-1,1194,yvrP,54.773869346733676,
7410,gene,3415386,3416196,-1,810,fhuC,55.18518518518518,
7411,CDS,3415386,3416196,-1,810,fhuC,55.18518518518518,
7413,CDS,3416211,3417222,-1,1011,fhuG,51.92878338278932,
7412,gene,3416211,3417222,-1,1011,fhuG,51.92878338278932,
7415,CDS,3417221,3418376,-1,1155,fhuB,50.90909090909091,
7414,gene,3417221,3418376,-1,1155,fhuB,50.90909090909091,
7416,gene,3418473,3419421,1,948,fhuD,56.0126582278481,
7417,CDS,3418473,3419421,1,948,fhuD,56.0126582278481,
7418,gene,3419655,3421065,-1,1410,lysP,53.90070921985816,
7419,CDS,3419655,3421065,-1,1410,lysP,53.90070921985816,
7420,gene,3421168,3421348,-1,180,kswB,46.666666666666664,
7421,misc_RNA,3421168,3421348,-1,180,kswB,46.666666666666664,
7423,CDS,3421464,3421605,-1,141,sspJ,65.95744680851064,
7422,gene,3421464,3421605,-1,141,sspJ,65.95744680851064,
7425,CDS,3421771,3422254,1,483,yvsG,55.072463768115945,
7424,gene,3421771,3422254,1,483,yvsG,55.072463768115945,
7426,gene,3422353,3424207,1,1854,ltaSP,57.17367853290184,
7427,CDS,3422353,3424207,1,1854,ltaSP,57.17367853290184,
7428,gene,3424234,3425161,-1,927,yvgK,53.5059331175836,
7429,CDS,3424234,3425161,-1,927,yvgK,53.5059331175836,
7430,gene,3425271,3426054,1,783,modA,58.10983397190294,
7431,CDS,3425271,3426054,1,783,modA,58.10983397190294,
7432,gene,3426025,3426718,1,693,modB,51.37085137085137,
7433,CDS,3426025,3426718,1,693,modB,51.37085137085137,
7434,gene,3426748,3427579,-1,831,pgoN,58.844765342960294,
7435,CDS,3426748,3427579,-1,831,pgoN,58.844765342960294,
7436,gene,3427801,3428287,1,486,yvgO,52.674897119341566,
7437,CDS,3427801,3428287,1,486,yvgO,52.674897119341566,
7438,gene,3428330,3430343,-1,2013,nhaK,55.29061102831595,
7439,CDS,3428330,3430343,-1,2013,nhaK,55.29061102831595,
7441,CDS,3430597,3432313,-1,1716,cysI,51.57342657342657,
7440,gene,3430597,3432313,-1,1716,cysI,51.57342657342657,
7443,CDS,3432338,3434156,-1,1818,cysJ,49.72497249724972,
7442,gene,3432338,3434156,-1,1818,cysJ,49.72497249724972,
7444,gene,3434326,3436651,-1,2325,helD,54.96774193548387,
7445,CDS,3434326,3436651,-1,2325,helD,54.96774193548387,
7446,gene,3436848,3437457,-1,609,yvgT,49.096880131362894,
7447,CDS,3436848,3437457,-1,609,yvgT,49.096880131362894,
7449,CDS,3437643,3438060,-1,417,bdbC,56.35491606714629,
7448,gene,3437643,3438060,-1,417,bdbC,56.35491606714629,
7451,CDS,3438064,3438733,-1,669,bdbD,58.14648729446936,
7450,gene,3438064,3438733,-1,669,bdbD,58.14648729446936,
7452,gene,3438852,3440961,-1,2109,cadA,52.726410621147465,
7453,CDS,3438852,3440961,-1,2109,cadA,52.726410621147465,
7454,gene,3441120,3443529,-1,2409,copA,52.3038605230386,
7455,CDS,3441120,3443529,-1,2409,copA,52.3038605230386,
7457,CDS,3443612,3443822,-1,210,copZ,54.761904761904766,
7456,gene,3443612,3443822,-1,210,copZ,54.761904761904766,
7458,gene,3443895,3444201,-1,306,csoR,59.150326797385624,
7459,CDS,3443895,3444201,-1,306,csoR,59.150326797385624,
7461,CDS,3444328,3445405,1,1077,iolW,54.50324976787372,
7460,gene,3444328,3445405,1,1077,iolW,54.50324976787372,
7462,gene,3445441,3446077,-1,636,azoRB,56.44654088050315,
7463,CDS,3445441,3446077,-1,636,azoRB,56.44654088050315,
7464,gene,3446236,3448132,-1,1896,yvaC,50.15822784810127,
7465,CDS,3446236,3448132,-1,1896,yvaC,50.15822784810127,
7466,gene,3448294,3448696,-1,402,yvaD,55.970149253731336,
7467,CDS,3448294,3448696,-1,402,yvaD,55.970149253731336,
7469,CDS,3448692,3449052,-1,360,yvaE,59.44444444444444,
7468,gene,3448692,3449052,-1,360,yvaE,59.44444444444444,
7471,CDS,3449048,3449621,-1,573,yvaF,59.33682373472949,
7470,gene,3449048,3449621,-1,573,yvaF,59.33682373472949,
7472,gene,3449731,3450526,-1,795,yvaG,52.70440251572327,
7473,CDS,3449731,3450526,-1,795,yvaG,52.70440251572327,
7474,gene,3450711,3451071,-1,360,ssrA,49.72222222222222,
7475,misc_RNA,3450711,3451071,-1,360,ssrA,49.72222222222222,
7477,CDS,3451247,3451718,-1,471,smpB,54.77707006369427,
7476,gene,3451247,3451718,-1,471,smpB,54.77707006369427,
7479,CDS,3451862,3454202,-1,2340,rnr,52.478632478632484,
7478,gene,3451862,3454202,-1,2340,rnr,52.478632478632484,
7480,gene,3454220,3454961,-1,741,estA,55.60053981106613,
7481,CDS,3454220,3454961,-1,741,estA,55.60053981106613,
7482,gene,3455092,3455323,-1,231,secG,57.14285714285714,
7483,CDS,3455092,3455323,-1,231,secG,57.14285714285714,
7484,gene,3455471,3456242,1,771,yvaM,52.788586251621275,
7485,CDS,3455471,3456242,1,771,yvaM,52.788586251621275,
7486,gene,3456281,3456515,-1,234,yvzC,59.82905982905983,
7487,CDS,3456281,3456515,-1,234,yvzC,59.82905982905983,
7488,gene,3456666,3457074,1,408,rghRA,54.166666666666664,
7489,CDS,3456666,3457074,1,408,rghRA,54.166666666666664,
7490,gene,3457103,3457523,1,420,rghRB,50.95238095238095,
7491,CDS,3457103,3457523,1,420,rghRB,50.95238095238095,
7493,CDS,3457614,3457941,1,327,catR,56.269113149847094,
7492,gene,3457614,3457941,1,327,catR,56.269113149847094,
7495,CDS,3458065,3459766,1,1701,yvaQ,56.20223398001176,
7494,gene,3458065,3459766,1,1701,yvaQ,56.20223398001176,
7496,gene,3459805,3460486,-1,681,opuBD,48.751835535976504,
7497,CDS,3459805,3460486,-1,681,opuBD,48.751835535976504,
7498,gene,3460502,3461423,-1,921,opuBC,53.74592833876222,
7499,CDS,3460502,3461423,-1,921,opuBC,53.74592833876222,
7501,CDS,3461434,3462088,-1,654,opuBB,51.681957186544345,
7500,gene,3461434,3462088,-1,654,opuBB,51.681957186544345,
7503,CDS,3462104,3463250,-1,1146,opuBA,52.09424083769634,
7502,gene,3462104,3463250,-1,1146,opuBA,52.09424083769634,
7504,gene,3463533,3464067,1,534,yvaV,57.11610486891385,
7505,CDS,3463533,3464067,1,534,yvaV,57.11610486891385,
7506,gene,3464288,3464765,1,477,sdpA,69.81132075471697,
7507,CDS,3464288,3464765,1,477,sdpA,69.81132075471697,
7508,gene,3464761,3465733,1,972,sdpB,71.60493827160494,
7509,CDS,3464761,3465733,1,972,sdpB,71.60493827160494,
7511,CDS,3465775,3466387,1,612,spbC,65.68627450980392,
7510,gene,3465775,3466387,1,612,spbC,65.68627450980392,
7513,CDS,3466433,3467057,-1,624,sdpI,71.31410256410257,
7512,gene,3466433,3467057,-1,624,sdpI,71.31410256410257,
7515,CDS,3467053,3467326,-1,273,sdpR,67.03296703296702,
7514,gene,3467053,3467326,-1,273,sdpR,67.03296703296702,
7516,gene,3467545,3468235,-1,690,opuCD,51.30434782608696,
7517,CDS,3467545,3468235,-1,690,opuCD,51.30434782608696,
7518,gene,3468252,3469164,-1,912,opuCC,55.372807017543856,
7519,CDS,3468252,3469164,-1,912,opuCC,55.372807017543856,
7520,gene,3469183,3469837,-1,654,opuCB,52.14067278287462,
7521,CDS,3469183,3469837,-1,654,opuCB,52.14067278287462,
7523,CDS,3469859,3471002,-1,1143,opuCA,53.105861767279094,
7522,gene,3469859,3471002,-1,1143,opuCA,53.105861767279094,
7524,gene,3471265,3471823,1,558,opcR,57.8853046594982,
7525,CDS,3471265,3471823,1,558,opcR,57.8853046594982,
7526,gene,3471840,3472476,-1,636,yvbG,54.87421383647799,
7527,CDS,3471840,3472476,-1,636,yvbG,54.87421383647799,
7528,gene,3472625,3473240,1,615,yvbH,60.16260162601627,
7529,CDS,3472625,3473240,1,615,yvbH,60.16260162601627,
7530,gene,3473371,3474070,1,699,yvbI,58.798283261802574,
7531,CDS,3473371,3474070,1,699,yvbI,58.798283261802574,
7532,gene,3474105,3475923,-1,1818,yvbJ,58.08580858085809,
7533,CDS,3474105,3475923,-1,1818,yvbJ,58.08580858085809,
7534,gene,3476042,3476510,1,468,yvbK,57.47863247863248,
7535,CDS,3476042,3476510,1,468,yvbK,57.47863247863248,
7536,gene,3476554,3477847,-1,1293,eno,54.44702242846095,
7537,CDS,3476554,3477847,-1,1293,eno,54.44702242846095,
7539,CDS,3477876,3479412,-1,1536,pgm,53.580729166666664,
7538,gene,3477876,3479412,-1,1536,pgm,53.580729166666664,
7540,gene,3479404,3480166,-1,762,tpiA,52.23097112860893,
7541,CDS,3479404,3480166,-1,762,tpiA,52.23097112860893,
7542,gene,3480196,3481381,-1,1185,pgk,53.417721518987335,
7543,CDS,3480196,3481381,-1,1185,pgk,53.417721518987335,
7544,gene,3481697,3482705,-1,1008,gapA,56.448412698412696,
7545,CDS,3481697,3482705,-1,1008,gapA,56.448412698412696,
7546,gene,3482751,3483774,-1,1023,cggR,54.154447702834794,
7547,CDS,3482751,3483774,-1,1023,cggR,54.154447702834794,
7548,gene,3484071,3485466,-1,1395,araE,54.83870967741935,
7549,CDS,3484071,3485466,-1,1395,araE,54.83870967741935,
7550,gene,3485669,3486758,1,1089,araR,54.729109274563825,
7551,CDS,3485669,3486758,1,1089,araR,54.729109274563825,
7552,gene,3486806,3487817,-1,1011,yvbT,48.6646884272997,
7553,CDS,3486806,3487817,-1,1011,yvbT,48.6646884272997,
7554,gene,3487973,3488852,-1,879,yvbU,52.104664391353815,
7555,CDS,3487973,3488852,-1,879,yvbU,52.104664391353815,
7556,gene,3488951,3489869,1,918,cyeB,49.78213507625273,
7557,CDS,3488951,3489869,1,918,cyeB,49.78213507625273,
7558,gene,3489909,3491253,-1,1344,yvbW,54.538690476190474,
7559,CDS,3489909,3491253,-1,1344,yvbW,54.538690476190474,
7560,gene,3491321,3491557,-1,236,tboX,52.96610169491526,
7561,misc_RNA,3491321,3491557,-1,236,tboX,52.96610169491526,
7562,gene,3491654,3492689,-1,1035,yvbX,59.033816425120776,
7563,CDS,3491654,3492689,-1,1035,yvbX,59.033816425120776,
7564,gene,3492796,3493519,-1,723,lutC,50.62240663900415,
7565,CDS,3492796,3493519,-1,723,lutC,50.62240663900415,
7566,gene,3493518,3494958,-1,1440,lutB,50.34722222222222,
7567,CDS,3493518,3494958,-1,1440,lutB,50.34722222222222,
7568,gene,3494984,3495701,-1,717,lutA,50.627615062761514,
7569,CDS,3494984,3495701,-1,717,lutA,50.627615062761514,
7570,gene,3495875,3496478,-1,603,yvfU,53.8971807628524,
7571,CDS,3495875,3496478,-1,603,yvfU,53.8971807628524,
7572,gene,3496494,3497610,-1,1116,yvfT,56.272401433691755,
7573,CDS,3496494,3497610,-1,1116,yvfT,56.272401433691755,
7574,gene,3497613,3498351,-1,738,yvfS,54.607046070460704,
7575,CDS,3497613,3498351,-1,738,yvfS,54.607046070460704,
7576,gene,3498351,3499257,-1,906,yvfR,54.52538631346579,
7577,CDS,3498351,3499257,-1,906,yvfR,54.52538631346579,
7578,gene,3499540,3500350,1,810,rsbQ,51.9753086419753,
7579,CDS,3499540,3500350,1,810,rsbQ,51.9753086419753,
7580,gene,3500385,3501597,1,1212,rsbP,57.17821782178218,
7581,CDS,3500385,3501597,1,1212,rsbP,57.17821782178218,
7582,gene,3501650,3502940,-1,1290,ganB,53.25581395348837,
7583,CDS,3501650,3502940,-1,1290,ganB,53.25581395348837,
7584,gene,3503019,3505083,-1,2064,ganA,51.40503875968992,
7585,CDS,3503019,3505083,-1,2064,ganA,51.40503875968992,
7586,gene,3505101,3505953,-1,852,ganQ,53.755868544600936,
7587,CDS,3505101,3505953,-1,852,ganQ,53.755868544600936,
7588,gene,3505956,3507213,-1,1257,ganP,57.04057279236277,
7589,CDS,3505956,3507213,-1,1257,ganP,57.04057279236277,
7590,gene,3507252,3508518,-1,1266,ganS,55.29225908372828,
7591,CDS,3507252,3508518,-1,1266,ganS,55.29225908372828,
7592,gene,3508658,3509651,-1,993,ganR,56.59617321248741,
7593,CDS,3508658,3509651,-1,993,ganR,56.59617321248741,
7594,gene,3509830,3510490,-1,660,lutR,50.75757575757576,
7595,CDS,3509830,3510490,-1,660,lutR,50.75757575757576,
7596,gene,3510779,3512471,1,1692,lutP,49.40898345153664,
7597,CDS,3510779,3512471,1,1692,lutP,49.40898345153664,
7598,gene,3512497,3513808,-1,1311,sigL,54.23340961098398,
7599,CDS,3512497,3513808,-1,1311,sigL,54.23340961098398,
7601,CDS,3513886,3514105,1,219,yvfG,60.73059360730594,
7600,gene,3513886,3514105,1,219,yvfG,60.73059360730594,
7603,CDS,3514114,3515083,-1,969,epsO,53.76676986584107,
7602,gene,3514114,3515083,-1,969,epsO,53.76676986584107,
7604,gene,3515061,3516228,-1,1167,epsN,50.6426735218509,
7605,CDS,3515061,3516228,-1,1167,epsN,50.6426735218509,
7606,gene,3516232,3516883,-1,651,epsM,45.314900153609834,
7607,CDS,3516232,3516883,-1,651,epsM,45.314900153609834,
7609,CDS,3516879,3517488,-1,609,epsL,51.39573070607554,
7608,gene,3516879,3517488,-1,609,epsL,51.39573070607554,
7611,CDS,3517484,3519002,-1,1518,epsK,52.43741765480896,
7610,gene,3517484,3519002,-1,1518,epsK,52.43741765480896,
7612,gene,3518998,3520033,-1,1035,epsJ,53.429951690821255,
7613,CDS,3518998,3520033,-1,1035,epsJ,53.429951690821255,
7614,gene,3520029,3521106,-1,1077,epsI,50.88207985143919,
7615,CDS,3520029,3521106,-1,1077,epsI,50.88207985143919,
7616,gene,3521110,3522145,-1,1035,epsH,52.56038647342996,
7617,CDS,3521110,3522145,-1,1035,epsH,52.56038647342996,
7618,gene,3522169,3523273,-1,1104,epsG,56.43115942028986,
7619,CDS,3522169,3523273,-1,1104,epsG,56.43115942028986,
7621,CDS,3523269,3524424,-1,1155,epsF,47.705627705627705,
7620,gene,3523269,3524424,-1,1155,epsF,47.705627705627705,
7622,gene,3524416,3525253,-1,837,epsE,52.44922341696535,
7623,CDS,3524416,3525253,-1,837,epsE,52.44922341696535,
7624,gene,3525249,3526395,-1,1146,epsD,50.523560209424076,
7625,CDS,3525249,3526395,-1,1146,epsD,50.523560209424076,
7627,CDS,3526406,3528203,-1,1797,epsC,53.08848080133556,
7626,gene,3526406,3528203,-1,1797,epsC,53.08848080133556,
7628,gene,3528461,3529145,-1,684,epsB,54.97076023391813,
7629,CDS,3528461,3529145,-1,684,epsB,54.97076023391813,
7631,CDS,3529150,3529855,-1,705,epsA,53.90070921985816,
7630,gene,3529150,3529855,-1,705,epsA,53.90070921985816,
7632,gene,3530100,3530559,1,459,slrR,59.04139433551199,
7633,CDS,3530100,3530559,1,459,slrR,59.04139433551199,
7634,gene,3530634,3532104,1,1470,pnbA,51.088435374149654,
7635,CDS,3530634,3532104,1,1470,pnbA,51.088435374149654,
7637,CDS,3532106,3532298,1,192,BSU_34399,54.166666666666664,
7636,gene,3532106,3532298,1,192,BSU_34399,54.166666666666664,
7639,CDS,3532324,3532810,-1,486,padC,60.90534979423868,
7638,gene,3532324,3532810,-1,486,padC,60.90534979423868,
7640,gene,3532832,3533144,-1,312,yveG,55.12820512820513,
7641,misc_feature,3532832,3533144,-1,312,yveG,55.12820512820513,
7642,gene,3533195,3533288,-1,93,yveF,53.76344086021505,
7643,misc_feature,3533195,3533288,-1,93,yveF,53.76344086021505,
7644,gene,3533418,3534102,-1,684,racX,55.409356725146196,
7645,CDS,3533418,3534102,-1,684,racX,55.409356725146196,
7646,gene,3534117,3535473,-1,1356,pbpE,54.86725663716814,
7647,CDS,3534117,3535473,-1,1356,pbpE,54.86725663716814,
7648,gene,3536011,3537433,1,1422,sacB,58.86075949367089,
7649,CDS,3536011,3537433,1,1422,sacB,58.86075949367089,
7650,gene,3537506,3539057,1,1551,levB,54.803352675693105,
7651,CDS,3537506,3539057,1,1551,levB,54.803352675693105,
7652,gene,3539164,3540727,1,1563,aspP,53.74280230326296,
7653,CDS,3539164,3540727,1,1563,aspP,53.74280230326296,
7654,gene,3540716,3541406,1,690,yvdT,61.30434782608696,
7655,CDS,3540716,3541406,1,690,yvdT,61.30434782608696,
7657,CDS,3541487,3541823,1,336,psmA,57.14285714285714,
7656,gene,3541487,3541823,1,336,psmA,57.14285714285714,
7658,gene,3541822,3542143,1,321,psmB,52.336448598130836,
7659,CDS,3541822,3542143,1,321,psmB,52.336448598130836,
7660,gene,3542178,3542691,-1,513,yvdQ,50.682261208576996,
7661,CDS,3542178,3542691,-1,513,yvdQ,50.682261208576996,
7662,gene,3542942,3544286,-1,1344,cotNP,58.63095238095239,
7663,CDS,3542942,3544286,-1,1344,cotNP,58.63095238095239,
7664,gene,3544641,3545604,1,963,cotR,55.24402907580478,
7665,CDS,3544641,3545604,1,963,cotR,55.24402907580478,
7667,tRNA,3545888,3545964,-1,76,trnQ-Arg,36.84210526315789,
7666,gene,3545888,3545964,-1,76,trnQ-Arg,36.84210526315789,
7668,gene,3546233,3546827,1,594,clpP,54.54545454545454,
7669,CDS,3546233,3546827,1,594,clpP,54.54545454545454,
7670,gene,3546872,3547553,-1,681,mdxM,55.800293685756245,
7671,CDS,3546872,3547553,-1,681,mdxM,55.800293685756245,
7673,CDS,3547549,3549235,-1,1686,mdxL,56.109134045077106,
7672,gene,3547549,3549235,-1,1686,mdxL,56.109134045077106,
7675,CDS,3549227,3551501,-1,2274,mdxK,55.10114335971856,
7674,gene,3549227,3551501,-1,2274,mdxK,55.10114335971856,
7676,gene,3551478,3552363,-1,885,mdxJ,56.045197740113,
7677,CDS,3551478,3552363,-1,885,mdxJ,56.045197740113,
7678,gene,3552368,3553205,-1,837,mdxG,54.00238948626045,
7679,CDS,3552368,3553205,-1,837,mdxG,54.00238948626045,
7681,CDS,3553205,3554513,-1,1308,mdxF,57.87461773700306,
7680,gene,3553205,3554513,-1,1308,mdxF,57.87461773700306,
7682,gene,3554552,3555806,-1,1254,mdxE,57.01754385964912,
7683,CDS,3554552,3555806,-1,1254,mdxE,57.01754385964912,
7684,gene,3555901,3557671,-1,1770,mdxD,56.440677966101696,
7685,CDS,3555901,3557671,-1,1770,mdxD,56.440677966101696,
7686,gene,3557783,3558734,-1,951,mdxR,55.099894847528915,
7687,CDS,3557783,3558734,-1,951,mdxR,55.099894847528915,
7689,CDS,3558939,3559515,-1,576,yvdD,53.645833333333336,
7688,gene,3558939,3559515,-1,576,yvdD,53.645833333333336,
7691,CDS,3559631,3559952,1,321,yvdC,54.20560747663551,
7690,gene,3559631,3559952,1,321,yvdC,54.20560747663551,
7693,CDS,3559978,3561571,-1,1593,yvdB,52.605147520401765,
7692,gene,3559978,3561571,-1,1593,yvdB,52.605147520401765,
7694,gene,3561589,3562183,-1,594,yvdA,55.218855218855225,
7695,CDS,3561589,3562183,-1,594,yvdA,55.218855218855225,
7696,gene,3562565,3563543,1,978,yvcT,54.90797546012271,
7697,CDS,3562565,3563543,1,978,yvcT,54.90797546012271,
7698,gene,3563580,3565521,-1,1941,psdB,58.835651725914474,
7699,CDS,3563580,3565521,-1,1941,psdB,58.835651725914474,
7700,gene,3565495,3566275,-1,780,psdA,54.35897435897436,
7701,CDS,3565495,3566275,-1,780,psdA,54.35897435897436,
7702,gene,3566357,3567428,-1,1071,psdS,54.808590102707754,
7703,CDS,3566357,3567428,-1,1071,psdS,54.808590102707754,
7704,gene,3567421,3568135,-1,714,psdR,56.30252100840336,
7705,CDS,3567421,3568135,-1,714,psdR,56.30252100840336,
7706,gene,3568281,3568491,1,210,yvzJ,63.8095238095238,
7707,CDS,3568281,3568491,1,210,yvzJ,63.8095238095238,
7709,CDS,3568526,3569291,-1,765,yvcN,53.98692810457516,
7708,gene,3568526,3569291,-1,765,yvcN,53.98692810457516,
7711,CDS,3569291,3569549,-1,258,crh,53.100775193798455,
7710,gene,3569291,3569549,-1,258,crh,53.100775193798455,
7712,gene,3569572,3570523,-1,951,whiA,57.72870662460568,
7713,CDS,3569572,3570523,-1,951,whiA,57.72870662460568,
7714,gene,3570545,3571499,-1,954,mgfK,53.24947589098532,
7715,CDS,3570545,3571499,-1,954,mgfK,53.24947589098532,
7716,gene,3571500,3572388,-1,888,yvcJ,55.18018018018018,
7717,CDS,3571500,3572388,-1,888,yvcJ,55.18018018018018,
7718,gene,3572412,3572889,-1,477,yvcI,53.878406708595385,
7719,CDS,3572412,3572889,-1,477,yvcI,53.878406708595385,
7720,gene,3573206,3574157,-1,951,trxB,55.83596214511041,
7721,CDS,3573206,3574157,-1,951,trxB,55.83596214511041,
7722,gene,3574362,3575784,-1,1422,cwlO,59.21237693389592,
7723,CDS,3574362,3575784,-1,1422,cwlO,59.21237693389592,secreted cell wall DL-endopeptidase
7725,CDS,3576164,3577619,-1,1455,yvcD,54.22680412371134,
7724,gene,3576164,3577619,-1,1455,yvcD,54.22680412371134,
7727,CDS,3577744,3579514,-1,1770,bmrA,53.163841807909606,
7726,gene,3577744,3579514,-1,1770,bmrA,53.163841807909606,
7729,CDS,3579678,3580038,-1,360,yvzA,63.05555555555556,
7728,gene,3579678,3580038,-1,360,yvzA,63.05555555555556,
7730,gene,3580052,3581963,-1,1911,yvcB,63.52694924123495,
7731,CDS,3580052,3581963,-1,1911,yvcB,63.52694924123495,
7732,gene,3581964,3582690,-1,726,yvcA,66.39118457300276,
7733,CDS,3581964,3582690,-1,726,yvcA,66.39118457300276,
7734,gene,3582935,3583565,-1,630,hisIE,49.682539682539684,
7735,CDS,3582935,3583565,-1,630,hisIE,49.682539682539684,
7736,gene,3583561,3584320,-1,759,hisF,49.80237154150198,
7737,CDS,3583561,3584320,-1,759,hisF,49.80237154150198,
7738,gene,3584316,3585054,-1,738,hisA,51.76151761517615,
7739,CDS,3584316,3585054,-1,738,hisA,51.76151761517615,
7741,CDS,3585050,3585689,-1,639,hisH,53.20813771517997,
7740,gene,3585050,3585689,-1,639,hisH,53.20813771517997,
7742,gene,3585689,3586274,-1,585,hisB,53.504273504273506,
7743,CDS,3585689,3586274,-1,585,hisB,53.504273504273506,
7744,gene,3586270,3587554,-1,1284,hisD,50.62305295950156,
7745,CDS,3586270,3587554,-1,1284,hisD,50.62305295950156,
7747,CDS,3587550,3588192,-1,642,hisG,50.467289719626166,
7746,gene,3587550,3588192,-1,642,hisG,50.467289719626166,
7749,CDS,3588184,3589360,-1,1176,hisZ,50.76530612244898,
7748,gene,3588184,3589360,-1,1176,hisZ,50.76530612244898,
7750,gene,3589610,3590363,1,753,yvpB,55.90969455511288,
7751,CDS,3589610,3590363,1,753,yvpB,55.90969455511288,
7752,gene,3590602,3591268,1,666,pelC,56.45645645645646,
7753,CDS,3590602,3591268,1,666,pelC,56.45645645645646,
7755,CDS,3591287,3591806,-1,519,hprF,53.5645472061657,
7754,gene,3591287,3591806,-1,519,hprF,53.5645472061657,
7756,gene,3591809,3592460,-1,651,ppaX,56.374807987711215,
7757,CDS,3591809,3592460,-1,651,ppaX,56.374807987711215,
7759,CDS,3592456,3593395,-1,939,yvoD,50.798722044728436,
7758,gene,3592456,3593395,-1,939,yvoD,50.798722044728436,
7760,gene,3593418,3594228,-1,810,lgt,53.333333333333336,
7761,CDS,3593418,3594228,-1,810,lgt,53.333333333333336,
7763,CDS,3594241,3595174,-1,933,hprK,52.09003215434084,
7762,gene,3594241,3595174,-1,933,hprK,52.09003215434084,
7765,CDS,3595355,3596546,1,1191,nagA,50.71368597816961,
7764,gene,3595355,3596546,1,1191,nagA,50.71368597816961,
7767,CDS,3596542,3597271,1,729,nagBA,53.223593964334704,
7766,gene,3596542,3597271,1,729,nagBA,53.223593964334704,
7768,gene,3597288,3598020,1,732,nagR,53.825136612021865,
7769,CDS,3597288,3598020,1,732,nagR,53.825136612021865,
7770,gene,3598039,3601909,-1,3870,yvnB,54.49612403100775,
7771,CDS,3598039,3601909,-1,3870,yvnB,54.49612403100775,
7772,gene,3602073,3602547,1,474,yvnA,62.65822784810127,
7773,CDS,3602073,3602547,1,474,yvnA,62.65822784810127,
7775,CDS,3602587,3603805,-1,1218,cypX,54.26929392446633,
7774,gene,3602587,3603805,-1,1218,cypX,54.26929392446633,
7777,CDS,3603820,3604567,-1,747,pchC,55.42168674698795,
7776,gene,3603820,3604567,-1,747,pchC,55.42168674698795,
7778,gene,3604992,3605502,1,510,pchR,61.96078431372549,
7779,CDS,3604992,3605502,1,510,pchR,61.96078431372549,
7780,gene,3605522,3606734,1,1212,pchE,55.940594059405946,
7781,CDS,3605522,3606734,1,1212,pchE,55.940594059405946,
7783,CDS,3606761,3607121,-1,360,yvlD,57.49999999999999,
7782,gene,3606761,3607121,-1,360,yvlD,57.49999999999999,
7784,gene,3607122,3607320,-1,198,yvlC,60.60606060606061,
7785,CDS,3607122,3607320,-1,198,yvlC,60.60606060606061,
7786,gene,3607324,3608422,-1,1098,yvlB,57.19489981785064,
7787,CDS,3607324,3608422,-1,1098,yvlB,57.19489981785064,
7788,gene,3608446,3608773,-1,327,yvlA,58.71559633027523,
7789,CDS,3608446,3608773,-1,327,yvlA,58.71559633027523,
7790,gene,3608990,3609221,1,231,yvkN,61.038961038961034,
7791,CDS,3608990,3609221,1,231,yvkN,61.038961038961034,
7792,gene,3609419,3609902,-1,483,yvzB,58.59213250517599,
7793,misc_feature,3609419,3609902,-1,483,yvzB,58.59213250517599,
7795,CDS,3610063,3612937,-1,2874,uvrA,51.42658315935977,
7794,gene,3610063,3612937,-1,2874,uvrA,51.42658315935977,
7796,gene,3612944,3614930,-1,1986,uvrB,52.31621349446123,
7797,CDS,3612944,3614930,-1,1986,uvrB,52.31621349446123,
7799,CDS,3615115,3615346,-1,231,csbA,63.63636363636363,
7798,gene,3615115,3615346,-1,231,csbA,63.63636363636363,
7800,gene,3615792,3618288,1,2496,yvkC,55.92948717948718,
7801,CDS,3615792,3618288,1,2496,yvkC,55.92948717948718,
7802,gene,3618363,3618933,1,570,yvkB,58.07017543859649,
7803,CDS,3618363,3618933,1,570,yvkB,58.07017543859649,
7804,gene,3618963,3620298,1,1335,yvkA,54.157303370786515,
7805,CDS,3618963,3620298,1,1335,yvkA,54.157303370786515,
7806,gene,3620345,3621539,-1,1194,minJ,53.266331658291456,
7807,CDS,3620345,3621539,-1,1194,minJ,53.266331658291456,
7808,gene,3621617,3621956,-1,339,swrAAc,66.07669616519173,
7809,misc_feature,3621617,3621956,-1,339,swrAAc,66.07669616519173,
7811,misc_feature,3621930,3622047,-1,117,swrAAn,60.68376068376068,
7810,gene,3621930,3622047,-1,117,swrAAn,60.68376068376068,
7812,gene,3622355,3623798,-1,1443,ctpB,56.54885654885655,
7813,CDS,3622355,3623798,-1,1443,ctpB,56.54885654885655,
7815,CDS,3623937,3624828,-1,891,ftsX,57.12682379349046,
7814,gene,3623937,3624828,-1,891,ftsX,57.12682379349046,
7816,gene,3624820,3625507,-1,687,ftsE,57.35080058224163,
7817,CDS,3624820,3625507,-1,687,ftsE,57.35080058224163,
7819,CDS,3625740,3626079,-1,339,cccB,55.16224188790561,
7818,gene,3625740,3626079,-1,339,cccB,55.16224188790561,
7820,gene,3626127,3627012,-1,885,yvjA,54.68926553672316,
7821,CDS,3626127,3627012,-1,885,yvjA,54.68926553672316,
7823,CDS,3627138,3628240,-1,1102,prfB,55.40417801998183,
7822,gene,3627138,3628240,-1,1102,prfB,55.44464609800362,
7824,gene,3628309,3630835,-1,2526,secA,54.513064133016634,
7825,CDS,3628309,3630835,-1,2526,secA,54.513064133016634,
7826,gene,3631002,3631572,-1,570,hpf,57.19298245614035,
7827,CDS,3631002,3631572,-1,570,hpf,57.19298245614035,
7829,CDS,3631762,3632140,-1,378,yvzG,65.07936507936508,
7828,gene,3631762,3632140,-1,378,yvzG,65.07936507936508,
7830,gene,3632149,3632491,-1,342,fliT,61.111111111111114,
7831,CDS,3632149,3632491,-1,342,fliT,61.111111111111114,
7833,CDS,3632487,3632889,-1,402,fliS,57.960199004975124,
7832,gene,3632487,3632889,-1,402,fliS,57.960199004975124,
7834,gene,3632910,3634407,-1,1497,fliD,60.25384101536406,
7835,CDS,3632910,3634407,-1,1497,fliD,60.25384101536406,
7837,CDS,3634424,3634754,-1,330,yvyC,63.030303030303024,
7836,gene,3634424,3634754,-1,330,yvyC,63.030303030303024,
7838,gene,3634986,3635901,-1,915,hag,58.797814207650276,
7839,CDS,3634986,3635901,-1,915,hag,58.797814207650276,
7841,CDS,3636045,3636270,-1,225,csrA,60.0,
7840,gene,3636045,3636270,-1,225,csrA,60.0,
7842,gene,3636263,3636695,-1,432,fliW,61.80555555555556,
7843,CDS,3636263,3636695,-1,432,fliW,61.80555555555556,
7844,gene,3636715,3637291,-1,576,yviE,56.770833333333336,
7845,CDS,3636715,3637291,-1,576,yviE,56.770833333333336,
7847,CDS,3637337,3638234,-1,897,flgL,60.200668896321076,
7846,gene,3637337,3638234,-1,897,flgL,60.200668896321076,
7848,gene,3638244,3639768,-1,1524,flgK,57.61154855643045,
7849,CDS,3638244,3639768,-1,1524,flgK,57.61154855643045,
7851,CDS,3639786,3640269,-1,483,flgN,59.42028985507246,
7850,gene,3639786,3640269,-1,483,flgN,59.42028985507246,
7852,gene,3640284,3640551,-1,267,flgM,66.29213483146067,
7853,CDS,3640284,3640551,-1,267,flgM,66.29213483146067,
7854,gene,3640631,3641051,-1,420,yvyF,61.42857142857143,
7855,CDS,3640631,3641051,-1,420,yvyF,61.42857142857143,
7856,gene,3641124,3641847,-1,723,comFC,59.47441217150761,
7857,CDS,3641124,3641847,-1,723,comFC,59.47441217150761,
7858,gene,3641810,3642107,-1,297,comFB,60.60606060606061,
7859,CDS,3641810,3642107,-1,297,comFB,60.60606060606061,
7860,gene,3642166,3643558,-1,1392,comFA,57.25574712643679,
7861,CDS,3642166,3643558,-1,1392,comFA,57.25574712643679,
7863,CDS,3643663,3644509,-1,846,fakBA,57.21040189125296,
7862,gene,3643663,3644509,-1,846,fakBA,57.21040189125296,
7865,CDS,3644606,3645296,-1,690,degU,57.68115942028985,
7864,gene,3644606,3645296,-1,690,degU,57.68115942028985,
7866,gene,3645378,3646536,-1,1158,degS,57.081174438687384,
7867,CDS,3645378,3646536,-1,1158,degS,57.081174438687384,
7869,CDS,3646752,3647406,1,654,yvyE,59.32721712538226,
7868,gene,3646752,3647406,1,654,yvyE,59.32721712538226,
7870,gene,3647405,3648581,1,1176,tagV,58.41836734693877,
7871,CDS,3647405,3648581,1,1176,tagV,58.41836734693877,
7872,gene,3648653,3649730,-1,1077,tagO,60.44568245125348,
7873,CDS,3648653,3649730,-1,1077,tagO,60.44568245125348,
7874,gene,3649874,3651068,-1,1194,tuaH,55.69514237855946,
7875,CDS,3649874,3651068,-1,1194,tuaH,55.69514237855946,
7876,gene,3651096,3651855,-1,759,tuaG,55.59947299077734,
7877,CDS,3651096,3651855,-1,759,tuaG,55.59947299077734,
7878,gene,3651878,3652559,-1,681,tuaF,57.12187958883994,
7879,CDS,3651878,3652559,-1,681,tuaF,57.12187958883994,
7881,CDS,3652587,3654054,-1,1467,tuaE,57.46421267893661,
7880,gene,3652587,3654054,-1,1467,tuaE,57.46421267893661,
7882,gene,3654138,3655524,-1,1386,tuaD,54.906204906204906,
7883,CDS,3654138,3655524,-1,1386,tuaD,54.906204906204906,
7885,CDS,3655585,3656755,-1,1170,tuaC,49.65811965811966,
7884,gene,3655585,3656755,-1,1170,tuaC,49.65811965811966,
7886,gene,3656751,3658203,-1,1452,tuaB,56.33608815426997,
7887,CDS,3656751,3658203,-1,1452,tuaB,56.33608815426997,
7889,misc_feature,3658258,3658408,-1,150,tuaAc,63.33333333333333,
7888,gene,3658258,3658408,-1,150,tuaAc,63.33333333333333,
7890,gene,3658406,3658892,-1,486,tuaAn,54.11522633744856,
7891,misc_feature,3658406,3658892,-1,486,tuaAn,54.11522633744856,
7893,CDS,3659118,3660609,-1,1491,lytC,60.8316566063045,
7892,gene,3659118,3660609,-1,1491,lytC,60.8316566063045,
7894,gene,3660647,3662765,-1,2118,lytB,62.46458923512748,
7895,CDS,3660647,3662765,-1,2118,lytB,62.46458923512748,
7896,gene,3662788,3663097,-1,309,lytA,64.72491909385113,
7897,CDS,3662788,3663097,-1,309,lytA,64.72491909385113,
7899,CDS,3663280,3664201,1,921,tagU,58.19761129207384,
7898,gene,3663280,3664201,1,921,tagU,58.19761129207384,
7901,CDS,3664240,3665383,-1,1143,mnaA,53.63079615048119,
7900,gene,3664240,3665383,-1,1143,mnaA,53.63079615048119,
7903,CDS,3665628,3666507,1,879,gtaB,56.996587030716725,
7902,gene,3665628,3666507,1,879,gtaB,56.996587030716725,
7904,gene,3666840,3667059,1,219,BSU_35678,60.273972602739725,
7905,CDS,3666840,3667059,1,219,BSU_35678,60.273972602739725,
7907,misc_feature,3666932,3667016,-1,84,yvzH,55.952380952380956,
7906,gene,3666932,3667016,-1,84,yvzH,55.952380952380956,
7908,gene,3667208,3669911,-1,2703,ggaB,71.18017018128006,
7909,CDS,3667208,3669911,-1,2703,ggaB,71.18017018128006,
7910,gene,3670034,3671375,-1,1341,ggaA,71.88665175242357,
7911,misc_feature,3670034,3671375,-1,1341,ggaA,71.88665175242357,
7912,gene,3671415,3671622,-1,207,yvzI,68.59903381642512,
7913,misc_feature,3671415,3671622,-1,207,yvzI,68.59903381642512,
7914,gene,3672928,3673525,1,597,yvzE,56.28140703517588,
7915,misc_feature,3672928,3673525,1,597,yvzE,56.28140703517588,
7917,CDS,3673563,3675147,-1,1584,tagH,59.34343434343434,
7916,gene,3673563,3675147,-1,1584,tagH,59.34343434343434,
7919,CDS,3675166,3675994,-1,828,tagG,62.80193236714976,
7918,gene,3675166,3675994,-1,828,tagG,62.80193236714976,
7920,gene,3676158,3678399,-1,2241,tagF,65.77420794288264,
7921,CDS,3676158,3678399,-1,2241,tagF,65.77420794288264,
7922,gene,3678398,3680420,-1,2022,tagE,66.86449060336301,
7923,CDS,3678398,3680420,-1,2022,tagE,66.86449060336301,
7924,gene,3680580,3680970,-1,390,tagD,65.8974358974359,
7925,CDS,3680580,3680970,-1,390,tagD,65.8974358974359,
7927,CDS,3681369,3682140,1,771,tagA,63.29442282749675,
7926,gene,3681369,3682140,1,771,tagA,63.29442282749675,
7928,gene,3682172,3683318,1,1146,tagB,67.97556719022687,
7929,CDS,3682172,3683318,1,1146,tagB,67.97556719022687,
7930,gene,3683437,3684766,1,1329,tagC,64.40933032355154,
7931,CDS,3683437,3684766,1,1329,tagC,64.40933032355154,
7932,gene,3684825,3687468,-1,2643,lytD,55.65645100264851,
7933,CDS,3684825,3687468,-1,2643,lytD,55.65645100264851,
7934,gene,3687596,3688547,-1,951,pmiA,54.15352260778128,
7935,CDS,3687596,3688547,-1,951,pmiA,54.15352260778128,
7936,gene,3688811,3690263,1,1452,gerBA,54.476584022038566,
7937,CDS,3688811,3690263,1,1452,gerBA,54.476584022038566,
7938,gene,3690268,3691375,1,1107,gerBB,58.89792231255646,
7939,CDS,3690268,3691375,1,1107,gerBB,58.89792231255646,
7940,gene,3691371,3692496,1,1125,gerBC,56.888888888888886,
7941,CDS,3691371,3692496,1,1125,gerBC,56.888888888888886,
7942,gene,3692532,3693906,-1,1374,ywtG,53.12954876273653,
7943,CDS,3692532,3693906,-1,1374,ywtG,53.12954876273653,
7944,gene,3694238,3695207,1,969,tagT,58.82352941176471,
7945,CDS,3694238,3695207,1,969,tagT,58.82352941176471,
7946,gene,3695362,3696223,1,861,ribZB,55.400696864111495,
7947,CDS,3695362,3696223,1,861,ribZB,55.400696864111495,
7948,gene,3696256,3697498,-1,1242,pgdS,53.864734299516904,
7949,CDS,3696256,3697498,-1,1242,pgdS,53.864734299516904,
7950,gene,3697638,3697806,-1,168,edmS,61.904761904761905,
7951,CDS,3697638,3697806,-1,168,edmS,61.904761904761905,
7952,gene,3697820,3698963,-1,1143,capA,56.25546806649169,
7953,CDS,3697820,3698963,-1,1143,capA,56.25546806649169,
7954,gene,3698981,3699431,-1,450,capC,60.22222222222222,
7955,CDS,3698981,3699431,-1,450,capC,60.22222222222222,
7956,gene,3699445,3700627,-1,1182,capB,56.93739424703892,
7957,CDS,3699445,3700627,-1,1182,capB,56.93739424703892,
7958,gene,3701410,3702391,1,981,rbsR,52.191641182466874,
7959,CDS,3701410,3702391,1,981,rbsR,52.191641182466874,
7960,gene,3702392,3703274,1,882,rbsK,49.09297052154195,
7961,CDS,3702392,3703274,1,882,rbsK,49.09297052154195,
7962,gene,3703270,3703666,1,396,rbsD,54.7979797979798,
7963,CDS,3703270,3703666,1,396,rbsD,54.7979797979798,
7964,gene,3703681,3705163,1,1482,rbsA,53.50877192982456,
7965,CDS,3703681,3705163,1,1482,rbsA,53.50877192982456,
7966,gene,3705164,3706133,1,969,rbsC,52.115583075335394,
7967,CDS,3705164,3706133,1,969,rbsC,52.115583075335394,
7968,gene,3706144,3707062,1,918,rbsB,54.46623093681917,
7969,CDS,3706144,3707062,1,918,rbsB,54.46623093681917,
7970,gene,3707143,3707680,1,537,ywsB,58.659217877094974,
7971,CDS,3707143,3707680,1,537,ywsB,58.659217877094974,putative cell wall binding enzyme
7972,gene,3707835,3708132,1,297,ywsA,57.91245791245792,
7973,CDS,3707835,3708132,1,297,ywsA,57.91245791245792,
7974,gene,3708171,3708699,-1,528,ywrO,54.54545454545454,
7975,CDS,3708171,3708699,-1,528,ywrO,54.54545454545454,
7976,gene,3708798,3709566,-1,768,alsD,56.640625,
7977,CDS,3708798,3709566,-1,768,alsD,56.640625,
7978,gene,3709627,3711340,-1,1713,alsS,54.290718038528894,
7979,CDS,3709627,3711340,-1,1713,alsS,54.290718038528894,
7980,gene,3711497,3712406,1,909,alsR,56.54565456545655,
7981,CDS,3711497,3712406,1,909,alsR,56.54565456545655,
7982,gene,3712616,3713945,1,1329,ywrK,62.22723852520692,
7983,CDS,3712616,3713945,1,1329,ywrK,62.22723852520692,
7984,gene,3714001,3714679,-1,678,ywrJ,64.0117994100295,
7985,CDS,3714001,3714679,-1,678,ywrJ,64.0117994100295,
7986,gene,3714738,3715881,-1,1143,cotB,65.44181977252843,
7987,CDS,3714738,3715881,-1,1143,cotB,65.44181977252843,
7988,gene,3716008,3717097,-1,1089,cotH,59.22865013774105,
7989,CDS,3716008,3717097,-1,1089,cotH,59.22865013774105,
7990,gene,3717237,3717825,1,588,cotG,62.414965986394556,
7991,CDS,3717237,3717825,1,588,cotG,62.414965986394556,
7992,gene,3717325,3717805,1,480,BSU_36079,62.083333333333336,
7993,CDS,3717325,3717805,1,480,BSU_36079,62.083333333333336,
7994,gene,3717998,3718616,1,618,ywrF,54.0453074433657,
7995,CDS,3717998,3718616,1,618,ywrF,54.0453074433657,
7996,gene,3718793,3719129,1,336,ywrE,67.55952380952381,
7997,CDS,3718793,3719129,1,336,ywrE,67.55952380952381,
7998,gene,3719133,3720711,-1,1578,hpxW,49.746514575411915,
7999,CDS,3719133,3720711,-1,1578,hpxW,49.746514575411915,
8000,gene,3720924,3721401,1,477,chrS,56.18448637316562,
8001,CDS,3720924,3721401,1,477,chrS,56.18448637316562,
8002,gene,3721414,3722008,1,594,chrB,53.87205387205387,
8003,CDS,3721414,3722008,1,594,chrB,53.87205387205387,
8004,gene,3722004,3722541,1,537,chrA,48.60335195530726,
8005,CDS,3722004,3722541,1,537,chrA,48.60335195530726,
8006,gene,3722567,3722789,-1,222,ywqO,55.85585585585585,
8007,CDS,3722567,3722789,-1,222,ywqO,55.85585585585585,
8008,gene,3722785,3723331,-1,546,ywqN,55.494505494505496,
8009,CDS,3722785,3723331,-1,546,ywqN,55.494505494505496,
8010,gene,3723453,3724335,1,882,ywqM,56.4625850340136,
8011,CDS,3723453,3724335,1,882,ywqM,56.4625850340136,
8012,gene,3724419,3725136,-1,717,nfi,53.13807531380753,
8013,CDS,3724419,3725136,-1,717,nfi,53.13807531380753,
8014,gene,3725145,3725610,-1,465,rttO,65.59139784946237,
8015,CDS,3725145,3725610,-1,465,rttO,65.59139784946237,
8016,gene,3725599,3727408,-1,1809,rttN,58.70646766169154,
8017,CDS,3725599,3727408,-1,1809,rttN,58.70646766169154,
8018,gene,3727426,3727687,-1,261,ywqI,57.8544061302682,
8019,CDS,3727426,3727687,-1,261,ywqI,57.8544061302682,
8020,gene,3727696,3728119,-1,423,ywqH,61.22931442080378,
8021,CDS,3727696,3728119,-1,423,ywqH,61.22931442080378,
8022,gene,3728335,3728461,-1,126,BSU_36215,58.730158730158735,
8023,CDS,3728335,3728461,-1,126,BSU_36215,58.730158730158735,
8024,gene,3728510,3729296,-1,786,ywqG,57.50636132315522,
8025,CDS,3728510,3729296,-1,786,ywqG,57.50636132315522,
8026,gene,3729487,3730810,-1,1323,uglF,52.30536659108088,
8027,CDS,3729487,3730810,-1,1323,uglF,52.30536659108088,
8028,gene,3731004,3731769,-1,765,ptpZ,54.37908496732026,
8029,CDS,3731004,3731769,-1,765,ptpZ,54.37908496732026,
8030,gene,3731821,3732535,-1,714,ptkA,53.78151260504202,
8031,CDS,3731821,3732535,-1,714,ptkA,53.78151260504202,
8032,gene,3732524,3733271,-1,747,tkmA,56.35876840696118,
8033,CDS,3732524,3733271,-1,747,tkmA,56.35876840696118,
8034,gene,3733504,3733648,-1,144,ywzD,68.75,
8035,CDS,3733504,3733648,-1,144,ywzD,68.75,
8036,gene,3733851,3735462,1,1611,ywqB,54.18994413407822,
8037,CDS,3733851,3735462,1,1611,ywqB,54.18994413407822,
8038,gene,3735448,3738217,1,2769,hepA,51.02925243770314,
8039,CDS,3735448,3738217,1,2769,hepA,51.02925243770314,
8040,gene,3738342,3739200,-1,858,ywpJ,52.33100233100233,
8041,CDS,3738342,3739200,-1,858,ywpJ,52.33100233100233,
8042,gene,3739205,3739982,-1,777,glcR,53.410553410553405,
8043,CDS,3739205,3739982,-1,777,glcR,53.410553410553405,
8044,gene,3740205,3740547,-1,342,ssbB,52.33918128654971,
8045,CDS,3740205,3740547,-1,342,ssbB,52.33918128654971,
8046,gene,3740623,3741007,-1,384,ywpG,66.14583333333334,
8047,CDS,3740623,3741007,-1,384,ywpG,66.14583333333334,
8048,gene,3741181,3741592,1,411,ywpF,59.61070559610706,
8049,CDS,3741181,3741592,1,411,ywpF,59.61070559610706,
8050,gene,3741731,3742040,-1,309,ywpE,58.89967637540453,
8051,CDS,3741731,3742040,-1,309,ywpE,58.89967637540453,
8052,gene,3742383,3743220,1,837,ywpD,59.25925925925925,
8053,CDS,3742383,3743220,1,837,ywpD,59.25925925925925,
8054,gene,3743266,3743659,-1,393,mscL,53.9440203562341,
8055,CDS,3743266,3743659,-1,393,mscL,53.9440203562341,
8056,gene,3743731,3744157,-1,426,fabZ,53.990610328638496,
8057,CDS,3743731,3744157,-1,426,fabZ,53.990610328638496,
8058,gene,3744348,3745413,1,1065,rapD,61.87793427230047,
8059,CDS,3744348,3745413,1,1065,rapD,61.87793427230047,
8060,gene,3745435,3746245,-1,810,flhP,53.086419753086425,
8061,CDS,3745435,3746245,-1,810,flhP,53.086419753086425,
8062,gene,3746278,3747091,-1,813,flhO,55.47355473554736,
8063,CDS,3746278,3747091,-1,813,flhO,55.47355473554736,
8064,gene,3747253,3748255,-1,1002,mbl,53.99201596806387,
8065,CDS,3747253,3748255,-1,1002,mbl,53.99201596806387,
8066,gene,3748420,3748702,-1,282,spoIIID,59.57446808510638,
8067,CDS,3748420,3748702,-1,282,spoIIID,59.57446808510638,
8068,gene,3748716,3748827,-1,111,usd,63.06306306306306,
8069,CDS,3748716,3748827,-1,111,usd,63.06306306306306,
8070,gene,3749051,3749465,1,414,ywoH,57.00483091787439,
8071,CDS,3749051,3749465,1,414,ywoH,57.00483091787439,
8072,gene,3749486,3750677,1,1191,ywoG,54.49202350965575,
8073,CDS,3749486,3750677,1,1191,ywoG,54.49202350965575,
8074,gene,3750767,3752174,-1,1407,ywoF,56.71641791044776,
8075,CDS,3750767,3752174,-1,1407,ywoF,56.71641791044776,
8076,gene,3752279,3753752,-1,1473,pucI,51.73116089613035,
8077,CDS,3752279,3753752,-1,1473,pucI,51.73116089613035,
8078,gene,3753932,3755291,-1,1359,ywoD,52.53863134657837,
8079,CDS,3753932,3755291,-1,1359,ywoD,52.53863134657837,
8080,gene,3755290,3755860,-1,570,ywoC,52.807017543859644,
8081,CDS,3755290,3755860,-1,570,ywoC,52.807017543859644,
8082,gene,3755966,3756134,-1,168,BSU_36499,54.166666666666664,
8083,misc_feature,3755966,3756134,-1,168,BSU_36499,54.166666666666664,
8084,gene,3756043,3756508,-1,465,ywoB,53.5483870967742,
8085,CDS,3756043,3756508,-1,465,ywoB,53.5483870967742,
8086,gene,3756789,3758004,1,1215,amtB,49.547325102880656,
8087,CDS,3756789,3758004,1,1215,amtB,49.547325102880656,
8088,gene,3758015,3758366,1,351,glnK,56.12535612535613,
8089,CDS,3758015,3758366,1,351,glnK,56.12535612535613,
8090,gene,3758546,3759128,1,582,bcrC,55.84192439862543,
8091,CDS,3758546,3759128,1,582,bcrC,55.84192439862543,
8092,gene,3759168,3759591,-1,423,ywnJ,56.26477541371159,
8093,CDS,3759168,3759591,-1,423,ywnJ,56.26477541371159,
8094,gene,3759701,3760553,-1,852,spoIIQ,58.920187793427225,
8095,CDS,3759701,3760553,-1,852,spoIIQ,58.920187793427225,
8096,gene,3760693,3761185,1,492,ywnH,52.84552845528455,
8097,CDS,3760693,3761185,1,492,ywnH,52.84552845528455,
8098,gene,3761181,3761700,1,519,ywnG,54.33526011560693,
8099,CDS,3761181,3761700,1,519,ywnG,54.33526011560693,
8100,gene,3761858,3761990,1,132,BSU_36575,59.09090909090909,
8101,CDS,3761858,3761990,1,132,BSU_36575,59.09090909090909,
8102,gene,3761986,3762421,-1,435,ywnF,58.160919540229884,
8103,CDS,3761986,3762421,-1,435,ywnF,58.160919540229884,
8104,gene,3762663,3764112,1,1449,clsA,56.935817805383024,
8105,CDS,3762663,3764112,1,1449,clsA,56.935817805383024,
8106,gene,3764132,3764906,-1,774,mta,55.68475452196382,
8107,CDS,3764132,3764906,-1,774,mta,55.68475452196382,
8108,gene,3765050,3765434,1,384,ywnC,57.8125,
8109,CDS,3765050,3765434,1,384,ywnC,57.8125,
8110,gene,3765468,3766110,-1,642,ywnB,54.20560747663551,
8111,CDS,3765468,3766110,-1,642,ywnB,54.20560747663551,
8112,gene,3766177,3766579,-1,402,ywnA,57.711442786069654,
8113,CDS,3766177,3766579,-1,402,ywnA,57.711442786069654,
8114,gene,3766713,3768423,-1,1710,ureC,49.29824561403508,
8115,CDS,3766713,3768423,-1,1710,ureC,49.29824561403508,
8116,gene,3768419,3768794,-1,375,ureB,49.86666666666667,
8117,CDS,3768419,3768794,-1,375,ureB,49.86666666666667,
8118,gene,3768790,3769108,-1,318,ureA,49.685534591194966,
8119,CDS,3768790,3769108,-1,318,ureA,49.685534591194966,
8120,gene,3769288,3769453,-1,165,ywzE,69.0909090909091,
8121,CDS,3769288,3769453,-1,165,ywzE,69.0909090909091,
8122,gene,3769625,3769808,-1,183,ywzF,44.80874316939891,
8123,misc_feature,3769625,3769808,-1,183,ywzF,44.80874316939891,
8124,gene,3770103,3770292,-1,189,csbD,59.78835978835979,
8125,CDS,3770103,3770292,-1,189,csbD,59.78835978835979,
8126,gene,3770364,3770865,-1,501,ywmF,58.88223552894212,
8127,CDS,3770364,3770865,-1,501,ywmF,58.88223552894212,
8128,gene,3770999,3772133,-1,1134,rapB,59.876543209876544,
8129,CDS,3770999,3772133,-1,1134,rapB,59.876543209876544,
8130,gene,3772324,3773350,-1,1026,moaA,53.70370370370371,
8131,CDS,3772324,3773350,-1,1026,moaA,53.70370370370371,
8132,gene,3773365,3774154,-1,789,fdhD,53.48542458808618,
8133,CDS,3773365,3774154,-1,789,fdhD,53.48542458808618,
8134,gene,3774399,3774561,-1,162,ywmE,63.580246913580254,
8135,CDS,3774399,3774561,-1,162,ywmE,63.580246913580254,
8136,gene,3774654,3775329,-1,675,ywmD,55.111111111111114,
8137,CDS,3774654,3775329,-1,675,ywmD,55.111111111111114,
8138,gene,3775381,3775522,-1,141,BSU_36739,60.28368794326241,
8139,CDS,3775381,3775522,-1,141,BSU_36739,60.28368794326241,
8140,gene,3775652,3776336,-1,684,ywmC,57.30994152046783,
8141,CDS,3775652,3776336,-1,684,ywmC,57.30994152046783,
8142,gene,3776721,3777753,-1,1032,spoIID,54.166666666666664,
8143,CDS,3776721,3777753,-1,1032,spoIID,54.166666666666664,
8144,gene,3777948,3779259,-1,1311,murAA,54.30968726163235,
8145,CDS,3777948,3779259,-1,1311,murAA,54.30968726163235,
8146,gene,3779292,3780033,-1,741,ywmB,63.83265856950068,
8147,CDS,3779292,3780033,-1,741,ywmB,63.83265856950068,
8148,gene,3780161,3780392,-1,231,ywzB,56.709956709956714,
8149,CDS,3780161,3780392,-1,231,ywzB,56.709956709956714,
8150,gene,3780561,3781035,1,474,ywmA,61.60337552742617,
8151,CDS,3780561,3781035,1,474,ywmA,61.60337552742617,
8152,gene,3781068,3781467,-1,399,atpC,47.368421052631575,
8153,CDS,3781068,3781467,-1,399,atpC,47.368421052631575,
8154,gene,3781490,3782912,-1,1422,atpD,52.67229254571026,
8155,CDS,3781490,3782912,-1,1422,atpD,52.67229254571026,
8156,gene,3782937,3783801,-1,864,atpG,54.97685185185185,
8157,CDS,3782937,3783801,-1,864,atpG,54.97685185185185,
8158,gene,3783877,3785386,-1,1509,atpA,51.2259774685222,
8159,CDS,3783877,3785386,-1,1509,atpA,51.2259774685222,
8160,gene,3785402,3785948,-1,546,atpH,56.59340659340659,
8161,CDS,3785402,3785948,-1,546,atpH,56.59340659340659,
8162,gene,3785944,3786457,-1,513,atpF,57.50487329434698,
8163,CDS,3785944,3786457,-1,513,atpF,57.50487329434698,
8164,gene,3786619,3786832,-1,213,atpE,54.929577464788736,
8165,CDS,3786619,3786832,-1,213,atpE,54.929577464788736,
8166,gene,3786877,3787612,-1,735,atpB,56.87074829931973,
8167,CDS,3786877,3787612,-1,735,atpB,56.87074829931973,
8168,gene,3787619,3788003,-1,384,atpI,60.677083333333336,
8169,CDS,3787619,3788003,-1,384,atpI,60.677083333333336,
8170,gene,3788425,3789055,-1,630,upp,55.55555555555556,
8171,CDS,3788425,3789055,-1,630,upp,55.55555555555556,
8172,gene,3789189,3790437,-1,1248,glyA,54.24679487179487,
8173,CDS,3789189,3790437,-1,1248,glyA,54.24679487179487,
8174,gene,3790643,3791186,-1,543,ywlG,47.32965009208103,
8175,CDS,3790643,3791186,-1,543,ywlG,47.32965009208103,
8176,gene,3791198,3791648,-1,450,rpiB,51.77777777777778,
8177,CDS,3791198,3791648,-1,450,rpiB,51.77777777777778,
8178,gene,3791804,3792257,-1,453,prpB,54.746136865342166,
8179,CDS,3791804,3792257,-1,453,prpB,54.746136865342166,
8180,gene,3792332,3792890,-1,558,mntP,50.358422939068106,
8181,CDS,3792332,3792890,-1,558,mntP,50.358422939068106,
8182,gene,3792968,3794009,-1,1041,tsaC,48.51104707012488,
8183,CDS,3792968,3794009,-1,1041,tsaC,48.51104707012488,
8184,gene,3794165,3794609,-1,444,ywlB,53.37837837837838,
8185,CDS,3794165,3794609,-1,444,ywlB,53.37837837837838,
8186,gene,3794675,3795350,-1,675,spoIIR,57.925925925925924,
8187,CDS,3794675,3795350,-1,675,spoIIR,57.925925925925924,
8188,gene,3795490,3795853,1,363,ywlA,62.8099173553719,
8189,CDS,3795490,3795853,1,363,ywlA,62.8099173553719,
8190,gene,3795869,3796157,-1,288,ywkF,53.125,
8191,CDS,3795869,3796157,-1,288,ywkF,53.125,
8192,gene,3796216,3797083,-1,867,prmC,54.4405997693195,
8193,CDS,3796216,3797083,-1,867,prmC,54.4405997693195,
8194,gene,3797084,3798155,-1,1071,prfA,53.59477124183007,
8195,CDS,3797084,3798155,-1,1071,prfA,53.59477124183007,
8196,gene,3798280,3798667,1,387,ywkD,53.48837209302325,
8197,CDS,3798280,3798667,1,387,ywkD,53.48837209302325,
8198,gene,3798788,3799343,1,555,racA,53.333333333333336,
8199,CDS,3798788,3799343,1,555,racA,53.333333333333336,
8200,gene,3799376,3800336,-1,960,ywkB,56.97916666666667,
8201,CDS,3799376,3800336,-1,960,ywkB,56.97916666666667,
8202,gene,3800417,3802166,-1,1749,maeA,57.40423098913665,
8203,CDS,3800417,3802166,-1,1749,maeA,57.40423098913665,
8204,gene,3802404,3802992,-1,588,tdk,53.2312925170068,
8205,CDS,3802404,3802992,-1,588,tdk,53.2312925170068,
8206,gene,3803080,3803281,-1,201,rpmEA,60.19900497512438,
8207,CDS,3803080,3803281,-1,201,rpmEA,60.19900497512438,
8208,gene,3803399,3804683,-1,1284,rho,53.426791277258566,
8209,CDS,3803399,3804683,-1,1284,rho,53.426791277258566,
8210,gene,3804713,3804875,-1,162,BSU_37089,61.111111111111114,
8211,CDS,3804713,3804875,-1,162,BSU_37089,61.111111111111114,
8212,gene,3805089,3806055,-1,966,glpX,50.0,
8213,CDS,3805089,3806055,-1,966,glpX,50.0,
8214,gene,3806085,3807375,-1,1290,murAB,49.84496124031008,
8215,CDS,3806085,3807375,-1,1290,murAB,49.84496124031008,
8216,gene,3807753,3808392,-1,639,tal,54.147104851330205,
8217,CDS,3807753,3808392,-1,639,tal,54.147104851330205,
8218,gene,3808511,3809369,-1,858,fbaA,56.060606060606055,
8219,CDS,3808511,3809369,-1,858,fbaA,56.060606060606055,
8220,gene,3809549,3809924,-1,375,spo0F,54.400000000000006,
8221,CDS,3809549,3809924,-1,375,spo0F,54.400000000000006,
8222,gene,3810089,3810611,1,522,ywjG,53.25670498084292,
8223,CDS,3810089,3810611,1,522,ywjG,53.25670498084292,
8224,gene,3810692,3812300,-1,1608,pyrG,52.98507462686567,
8225,CDS,3810692,3812300,-1,1608,pyrG,52.98507462686567,
8226,gene,3812541,3813063,-1,522,rpoE,59.38697318007663,
8227,CDS,3812541,3813063,-1,522,rpoE,59.38697318007663,
8228,gene,3813245,3814385,-1,1140,acdA,51.05263157894737,
8229,CDS,3813245,3814385,-1,1140,acdA,51.05263157894737,
8230,gene,3814381,3816499,-1,2118,fadF,51.13314447592068,
8231,CDS,3814381,3816499,-1,2118,fadF,51.13314447592068,
8232,gene,3816653,3817850,1,1197,clsB,55.806182121971595,
8233,CDS,3816653,3817850,1,1197,clsB,55.806182121971595,
8234,gene,3817862,3818825,1,963,uvsE,53.271028037383175,
8235,CDS,3817862,3818825,1,963,uvsE,53.271028037383175,
8236,gene,3818905,3819178,1,273,ywjC,63.003663003663,
8237,CDS,3818905,3819178,1,273,ywjC,63.003663003663,
8238,gene,3819219,3819744,-1,525,ywjB,56.57142857142857,
8239,CDS,3819219,3819744,-1,525,ywjB,56.57142857142857,
8240,gene,3819753,3821481,-1,1728,ywjA,51.793981481481474,
8241,CDS,3819753,3821481,-1,1728,ywjA,51.793981481481474,
8242,gene,3821569,3823072,-1,1503,clsC,54.690618762475054,
8243,CDS,3821569,3823072,-1,1503,clsC,54.690618762475054,
8244,gene,3823557,3824229,-1,672,narI,49.851190476190474,
8245,CDS,3823557,3824229,-1,672,narI,49.851190476190474,
8246,gene,3824225,3824780,-1,555,narJ,51.17117117117117,
8247,CDS,3824225,3824780,-1,555,narJ,51.17117117117117,
8248,gene,3824805,3826269,-1,1464,narH,51.91256830601093,
8249,CDS,3824805,3826269,-1,1464,narH,51.91256830601093,
8250,gene,3826258,3829945,-1,3687,narG,50.0406834825061,
8251,CDS,3826258,3829945,-1,3687,narG,50.0406834825061,
8252,gene,3830140,3830617,-1,477,arfM,60.79664570230609,
8253,CDS,3830140,3830617,-1,477,arfM,60.79664570230609,
8254,gene,3830760,3831480,1,720,ywiC,52.22222222222223,
8255,CDS,3830760,3831480,1,720,ywiC,52.22222222222223,
8256,gene,3831511,3832228,-1,717,fnr,57.182705718270576,
8257,CDS,3831511,3832228,-1,717,fnr,57.182705718270576,
8258,gene,3832326,3833514,-1,1188,narK,52.69360269360269,
8259,CDS,3832326,3833514,-1,1188,narK,52.69360269360269,
8260,gene,3833649,3835320,-1,1671,argS,51.4063435068821,
8261,CDS,3833649,3835320,-1,1671,argS,51.4063435068821,
8262,gene,3835316,3835745,-1,429,ywiB,57.80885780885781,
8263,CDS,3835316,3835745,-1,429,ywiB,57.80885780885781,
8264,gene,3836057,3836189,1,132,sboA,53.78787878787878,
8265,CDS,3836057,3836189,1,132,sboA,53.78787878787878,
8266,gene,3836145,3836298,1,153,sboX,63.39869281045751,
8267,CDS,3836145,3836298,1,153,sboX,63.39869281045751,
8268,gene,3836322,3837669,1,1347,albA,55.08537490720119,
8269,CDS,3836322,3837669,1,1347,albA,55.08537490720119,
8270,gene,3837681,3837843,1,162,albB,56.17283950617284,
8271,CDS,3837681,3837843,1,162,albB,56.17283950617284,
8272,gene,3837839,3838559,1,720,albC,53.75,
8273,CDS,3837839,3838559,1,720,albC,53.75,
8274,gene,3838551,3839862,1,1311,albD,53.31807780320366,
8275,CDS,3838551,3839862,1,1311,albD,53.31807780320366,
8276,gene,3839851,3841012,1,1161,albE,52.62704565030146,
8277,CDS,3839851,3841012,1,1161,albE,52.62704565030146,
8278,gene,3841016,3842297,1,1281,albF,54.02029664324747,
8279,CDS,3841016,3842297,1,1281,albF,54.02029664324747,
8280,gene,3842293,3842995,1,702,albG,51.99430199430199,
8281,CDS,3842293,3842995,1,702,albG,51.99430199430199,
8282,gene,3843000,3844377,-1,1377,ywhL,55.04720406681191,
8283,CDS,3843000,3844377,-1,1377,ywhL,55.04720406681191,
8284,gene,3844415,3845771,-1,1356,ywhK,56.56342182890855,
8285,CDS,3844415,3845771,-1,1356,ywhK,56.56342182890855,
8286,gene,3846000,3847146,1,1146,rapF,64.31064572425828,
8287,CDS,3846000,3847146,1,1146,rapF,64.31064572425828,
8288,gene,3847129,3847249,1,120,phrF,61.66666666666667,
8289,CDS,3847129,3847249,1,120,phrF,61.66666666666667,
8290,gene,3847347,3847821,1,474,ywhH,54.43037974683544,
8291,CDS,3847347,3847821,1,474,ywhH,54.43037974683544,
8292,gene,3847852,3848725,-1,873,speB,49.36998854524628,
8293,CDS,3847852,3848725,-1,873,speB,49.36998854524628,
8294,gene,3848785,3849616,-1,831,speE,55.836341756919374,
8295,CDS,3848785,3849616,-1,831,speE,55.836341756919374,
8296,gene,3849817,3851893,1,2076,pbpG,49.662813102119465,
8297,CDS,3849817,3851893,1,2076,pbpG,49.662813102119465,
8298,gene,3852185,3852704,-1,519,ywhD,55.49132947976878,
8299,CDS,3852185,3852704,-1,519,ywhD,55.49132947976878,
8300,gene,3852717,3853377,-1,660,ywhC,52.57575757575758,
8301,CDS,3852717,3853377,-1,660,ywhC,52.57575757575758,
8302,gene,3853485,3853674,1,189,hmtB,57.67195767195767,
8303,CDS,3853485,3853674,1,189,hmtB,57.67195767195767,
8304,gene,3853716,3854136,-1,420,ywhA,54.761904761904766,
8305,CDS,3853716,3854136,-1,420,ywhA,54.761904761904766,
8306,gene,3854255,3856172,-1,1917,thrZ,51.06937923839332,
8307,CDS,3854255,3856172,-1,1917,thrZ,51.06937923839332,
8308,gene,3856225,3856447,-1,222,tboTB,52.25225225225225,
8309,misc_RNA,3856225,3856447,-1,222,tboTB,52.25225225225225,
8310,gene,3856478,3856700,-1,222,tboTA,52.25225225225225,
8311,misc_RNA,3856478,3856700,-1,222,tboTA,52.25225225225225,
8312,gene,3856781,3856937,-1,156,BSU_37569,53.84615384615385,
8313,CDS,3856781,3856937,-1,156,BSU_37569,53.84615384615385,
8314,gene,3857016,3858417,-1,1401,mmr,48.17987152034261,
8315,CDS,3857016,3858417,-1,1401,mmr,48.17987152034261,
8316,gene,3858416,3858887,-1,471,ywgB,53.29087048832272,
8317,CDS,3858416,3858887,-1,471,ywgB,53.29087048832272,
8318,gene,3858998,3859499,-1,501,ywgA,59.08183632734531,
8319,CDS,3858998,3859499,-1,501,ywgA,59.08183632734531,
8320,gene,3859534,3860836,-1,1302,ywfO,52.53456221198156,
8321,CDS,3859534,3860836,-1,1302,ywfO,52.53456221198156,
8322,gene,3860997,3861222,-1,225,ywzC,56.44444444444444,
8323,CDS,3860997,3861222,-1,225,ywzC,56.44444444444444,
8324,gene,3861436,3862213,1,777,psrF,55.5984555984556,
8325,CDS,3861436,3862213,1,777,psrF,55.5984555984556,
8326,gene,3862356,3863247,-1,891,ywfM,47.586980920314254,
8327,CDS,3862356,3863247,-1,891,ywfM,47.586980920314254,
8328,gene,3863414,3864260,-1,846,lipL,52.600472813238774,
8329,CDS,3863414,3864260,-1,846,lipL,52.600472813238774,
8330,gene,3864308,3865208,-1,900,cysL,56.00000000000001,
8331,CDS,3864308,3865208,-1,900,cysL,56.00000000000001,
8332,gene,3865354,3866326,-1,972,pta,54.93827160493827,
8333,CDS,3865354,3866326,-1,972,pta,54.93827160493827,
8334,gene,3866595,3867360,1,765,hemQ,55.032679738562095,
8335,CDS,3866595,3867360,1,765,hemQ,55.032679738562095,
8336,gene,3867492,3868272,1,780,bacG,54.35897435897436,
8337,CDS,3867492,3868272,1,780,bacG,54.35897435897436,
8338,gene,3868286,3869486,-1,1200,bacF,53.0,
8339,CDS,3868286,3869486,-1,1200,bacF,53.0,
8340,gene,3869486,3870671,-1,1185,bacE,54.008438818565395,
8341,CDS,3869486,3870671,-1,1185,bacE,54.008438818565395,
8342,gene,3870667,3872086,-1,1419,bacD,55.81395348837209,
8343,CDS,3870667,3872086,-1,1419,bacD,55.81395348837209,
8344,gene,3872104,3872866,-1,762,bacC,51.574803149606296,
8345,CDS,3872104,3872866,-1,762,bacC,51.574803149606296,
8346,gene,3872868,3873576,-1,708,bacB,54.09604519774012,
8347,CDS,3872868,3873576,-1,708,bacB,54.09604519774012,
8348,gene,3873565,3874180,-1,615,bacA,59.83739837398374,
8349,CDS,3873565,3874180,-1,615,bacA,59.83739837398374,
8350,gene,3874331,3875570,-1,1239,ywfA,53.026634382566584,
8351,CDS,3874331,3875570,-1,1239,ywfA,53.026634382566584,
8352,gene,3875779,3877192,-1,1413,rocC,52.86624203821656,
8353,CDS,3875779,3877192,-1,1413,rocC,52.86624203821656,
8354,gene,3877191,3878892,-1,1701,rocB,55.67313345091123,
8355,CDS,3877191,3878892,-1,1701,rocB,55.67313345091123,
8356,gene,3878965,3880513,-1,1548,rocA,51.80878552971576,
8357,CDS,3878965,3880513,-1,1548,rocA,51.80878552971576,
8358,gene,3880739,3882014,-1,1275,rocG,50.431372549019606,
8359,CDS,3880739,3882014,-1,1275,rocG,50.431372549019606,
8360,gene,3882190,3882655,-1,465,bslB,57.8494623655914,
8361,CDS,3882190,3882655,-1,465,bslB,57.8494623655914,
8362,gene,3882978,3883434,-1,456,spsL,54.166666666666664,
8363,CDS,3882978,3883434,-1,456,spsL,54.166666666666664,
8364,gene,3883426,3884278,-1,852,spsK,50.23474178403756,
8365,CDS,3883426,3884278,-1,852,spsK,50.23474178403756,
8366,gene,3884291,3885239,-1,948,spsJ,50.31645569620253,
8367,CDS,3884291,3885239,-1,948,spsJ,50.31645569620253,
8368,gene,3885238,3885979,-1,741,spsI,55.60053981106613,
8369,CDS,3885238,3885979,-1,741,spsI,55.60053981106613,
8370,gene,3886003,3887023,-1,1020,spsG,53.529411764705884,
8371,CDS,3886003,3887023,-1,1020,spsG,53.529411764705884,
8372,gene,3887025,3887748,-1,723,spsF,52.558782849239286,
8373,CDS,3887025,3887748,-1,723,spsF,52.558782849239286,
8374,gene,3887740,3888862,-1,1122,spsE,50.71301247771836,
8375,CDS,3887740,3888862,-1,1122,spsE,50.71301247771836,
8376,gene,3888861,3889731,-1,870,spsD,53.67816091954023,
8377,CDS,3888861,3889731,-1,870,spsD,53.67816091954023,
8378,gene,3889731,3890901,-1,1170,spsC,51.53846153846153,
8379,CDS,3889731,3890901,-1,1170,spsC,51.53846153846153,
8380,gene,3890921,3892346,-1,1425,spsB,55.1578947368421,
8381,CDS,3890921,3892346,-1,1425,spsB,55.1578947368421,
8382,gene,3892350,3893121,-1,771,spsA,56.42023346303502,
8383,CDS,3892350,3893121,-1,771,spsA,56.42023346303502,
8384,gene,3893440,3893986,1,546,gerQ,50.366300366300365,
8385,CDS,3893440,3893986,1,546,gerQ,50.366300366300365,
8386,gene,3894029,3894401,-1,372,ywdK,52.68817204301075,
8387,CDS,3894029,3894401,-1,372,ywdK,52.68817204301075,
8388,gene,3894462,3895785,-1,1323,ywdJ,52.53212396069539,
8389,CDS,3894462,3895785,-1,1323,ywdJ,52.53212396069539,
8390,gene,3895804,3896122,-1,318,ywdI,52.20125786163522,
8391,CDS,3895804,3896122,-1,318,ywdI,52.20125786163522,
8392,gene,3896289,3897660,1,1371,ywdH,50.76586433260394,
8393,CDS,3896289,3897660,1,1371,ywdH,50.76586433260394,
8394,gene,3897684,3898362,-1,678,ung,51.474926253687315,
8395,CDS,3897684,3898362,-1,678,ung,51.474926253687315,
8396,gene,3898375,3899182,-1,807,ywdF,52.41635687732342,
8397,CDS,3898375,3899182,-1,807,ywdF,52.41635687732342,
8398,gene,3899271,3899805,-1,534,ywdE,55.0561797752809,
8399,CDS,3899271,3899805,-1,534,ywdE,55.0561797752809,
8400,gene,3899852,3900488,-1,636,ywdD,57.861635220125784,
8401,CDS,3899852,3900488,-1,636,ywdD,57.861635220125784,
8402,gene,3900480,3900819,-1,339,ywzG,52.21238938053098,
8403,CDS,3900480,3900819,-1,339,ywzG,52.21238938053098,
8404,gene,3900962,3901778,1,816,pdxK,51.83823529411765,
8405,CDS,3900962,3901778,1,816,pdxK,51.83823529411765,
8406,gene,3901867,3902116,-1,249,ywdA,61.84738955823293,
8407,CDS,3901867,3902116,-1,249,ywdA,61.84738955823293,
8408,gene,3902209,3903649,-1,1440,sacA,51.18055555555555,
8409,CDS,3902209,3903649,-1,1440,sacA,51.18055555555555,
8410,gene,3903645,3905031,-1,1386,sacP,52.81385281385281,
8411,CDS,3903645,3905031,-1,1386,sacP,52.81385281385281,
8412,gene,3905332,3906103,1,771,nirC,54.345006485084305,
8413,CDS,3905332,3906103,1,771,nirC,54.345006485084305,
8414,gene,3906141,3906972,-1,831,sacT,56.55836341756919,
8415,CDS,3906141,3906972,-1,831,sacT,56.55836341756919,
8416,gene,3907011,3907314,-1,303,ywcI,49.17491749174918,
8417,CDS,3907011,3907314,-1,303,ywcI,49.17491749174918,
8418,gene,3907843,3910264,1,2421,vpr,52.12722015695993,
8419,CDS,3907843,3910264,1,2421,vpr,52.12722015695993,
8420,gene,3910301,3911303,-1,1002,ywcH,51.29740518962076,
8421,CDS,3910301,3911303,-1,1002,ywcH,51.29740518962076,
8422,gene,3911476,3912226,-1,750,nfrAA,56.266666666666666,
8423,CDS,3911476,3912226,-1,750,nfrAA,56.266666666666666,
8424,gene,3912331,3913513,-1,1182,rodA,62.2673434856176,
8425,CDS,3912331,3913513,-1,1182,rodA,62.2673434856176,
8426,gene,3914008,3914272,1,264,ywcE,57.57575757575758,
8427,CDS,3914008,3914272,1,264,ywcE,57.57575757575758,
8428,gene,3914314,3914689,-1,375,qoxD,52.0,
8429,CDS,3914314,3914689,-1,375,qoxD,52.0,
8430,gene,3914690,3915305,-1,615,qoxC,56.58536585365853,
8431,CDS,3914690,3915305,-1,615,qoxC,56.58536585365853,
8432,gene,3915318,3917268,-1,1950,qoxB,56.56410256410257,
8433,CDS,3915318,3917268,-1,1950,qoxB,56.56410256410257,
8434,gene,3917295,3918261,-1,966,qoxA,58.07453416149069,
8435,CDS,3917295,3918261,-1,966,qoxA,58.07453416149069,
8436,gene,3918776,3919022,1,246,ywzA,52.4390243902439,
8437,CDS,3918776,3919022,1,246,ywzA,52.4390243902439,
8438,gene,3919092,3920634,-1,1542,galT,51.36186770428015,
8439,CDS,3919092,3920634,-1,1542,galT,51.36186770428015,
8440,gene,3920637,3921810,-1,1173,galK,53.87894288150042,
8441,CDS,3920637,3921810,-1,1173,galK,53.87894288150042,
8442,gene,3921890,3922274,-1,384,ywcD,59.114583333333336,
8443,CDS,3921890,3922274,-1,384,ywcD,59.114583333333336,putative cell wall glycosylation protein
8444,gene,3922291,3922963,-1,672,slrC,58.779761904761905,
8445,CDS,3922291,3922963,-1,672,slrC,58.779761904761905,
8446,gene,3923318,3923477,1,159,slrA,63.52201257861635,
8447,CDS,3923318,3923477,1,159,slrA,63.52201257861635,
8448,gene,3923919,3924228,1,309,vbfB,58.252427184466015,
8449,CDS,3923919,3924228,1,309,vbfB,58.252427184466015,
8450,gene,3924224,3925766,1,1542,vbfA,49.6757457846952,
8451,CDS,3924224,3925766,1,1542,vbfA,49.6757457846952,
8452,gene,3925796,3926399,-1,603,ywbO,54.56053067993366,
8453,CDS,3925796,3926399,-1,603,ywbO,54.56053067993366,
8454,gene,3926681,3927932,-1,1251,efeB,51.398880895283774,
8455,CDS,3926681,3927932,-1,1251,efeB,51.398880895283774,
8456,gene,3927950,3929108,-1,1158,efeM,56.82210708117444,
8457,CDS,3927950,3929108,-1,1158,efeM,56.82210708117444,
8458,gene,3929104,3930550,-1,1446,efeU,52.4896265560166,
8459,CDS,3929104,3930550,-1,1446,efeU,52.4896265560166,
8460,gene,3930706,3931375,-1,669,thiE,51.12107623318386,
8461,CDS,3930706,3931375,-1,669,thiE,51.12107623318386,
8462,gene,3931371,3932190,-1,819,thiM,47.25274725274725,
8463,CDS,3931371,3932190,-1,819,thiM,47.25274725274725,
8464,gene,3932197,3933103,-1,906,cidR,54.083885209713024,
8465,CDS,3932197,3933103,-1,906,cidR,54.083885209713024,
8466,gene,3933208,3933595,1,387,cidA,59.17312661498708,
8467,CDS,3933208,3933595,1,387,cidA,59.17312661498708,
8468,gene,3933576,3934254,1,678,cidB,50.0,
8469,CDS,3933576,3934254,1,678,cidB,50.0,
8470,gene,3934357,3935557,1,1200,ywbF,54.166666666666664,
8471,CDS,3934357,3935557,1,1200,ywbF,54.166666666666664,
8472,gene,3935590,3935788,1,198,ywbE,55.55555555555556,
8473,CDS,3935590,3935788,1,198,ywbE,55.55555555555556,
8474,gene,3935823,3937014,-1,1191,rlmI,52.72879932829555,
8475,CDS,3935823,3937014,-1,1191,rlmI,52.72879932829555,
8476,gene,3937134,3937515,1,381,glxA,54.85564304461942,
8477,CDS,3937134,3937515,1,381,glxA,54.85564304461942,
8478,gene,3937552,3938230,-1,678,ywbB,60.32448377581121,
8479,CDS,3937552,3938230,-1,678,ywbB,60.32448377581121,
8480,gene,3938306,3939641,-1,1335,ywbA,47.640449438202246,
8481,CDS,3938306,3939641,-1,1335,ywbA,47.640449438202246,
8482,gene,3939868,3941806,1,1938,epr,53.56037151702786,
8483,CDS,3939868,3941806,1,1938,epr,53.56037151702786,
8484,gene,3942233,3943613,1,1380,sacX,51.59420289855072,
8485,CDS,3942233,3943613,1,1380,sacX,51.59420289855072,
8486,gene,3943666,3944509,1,843,sacY,60.02372479240806,
8487,CDS,3943666,3944509,1,843,sacY,60.02372479240806,
8488,gene,3944559,3945420,-1,861,gspA,58.30429732868757,
8489,CDS,3944559,3945420,-1,861,gspA,58.30429732868757,
8490,gene,3945529,3946243,-1,714,ywaF,54.761904761904766,
8491,CDS,3945529,3946243,-1,714,ywaF,54.761904761904766,
8492,gene,3946393,3946909,1,516,tyrZR,54.263565891472865,
8493,CDS,3946393,3946909,1,516,tyrZR,54.263565891472865,
8494,gene,3946909,3947116,1,207,tboYB,46.85990338164252,
8495,misc_RNA,3946909,3947116,1,207,tboYB,46.85990338164252,
8496,gene,3947157,3948399,1,1242,tyrZ,54.66988727858293,
8497,CDS,3947157,3948399,1,1242,tyrZ,54.66988727858293,
8498,gene,3948554,3949922,1,1368,eapD,52.33918128654971,
8499,CDS,3948554,3949922,1,1368,eapD,52.33918128654971,
8500,gene,3949951,3950584,-1,633,relQ,61.45339652448657,
8501,CDS,3949951,3950584,-1,633,relQ,61.45339652448657,
8502,gene,3950725,3951661,-1,936,menA,52.45726495726496,
8503,CDS,3950725,3951661,-1,936,menA,52.45726495726496,
8504,gene,3951823,3951958,-1,135,BSU_38495,70.37037037037037,
8505,CDS,3951823,3951958,-1,135,BSU_38495,70.37037037037037,
8506,gene,3952107,3952257,1,150,ywzH,65.33333333333333,
8507,CDS,3952107,3952257,1,150,ywzH,65.33333333333333,
8508,gene,3952274,3953786,1,1512,dltA,52.050264550264544,
8509,CDS,3952274,3953786,1,1512,dltA,52.050264550264544,
8510,gene,3953782,3954970,1,1188,dltB,56.56565656565656,
8511,CDS,3953782,3954970,1,1188,dltB,56.56565656565656,
8512,gene,3954986,3955223,1,237,dltC,63.71308016877637,
8513,CDS,3954986,3955223,1,237,dltC,63.71308016877637,
8514,gene,3955222,3956401,1,1179,dltD,55.470737913486005,
8515,CDS,3955222,3956401,1,1179,dltD,55.470737913486005,
8516,gene,3956491,3957250,1,759,dltE,51.91040843214756,
8517,CDS,3956491,3957250,1,759,dltE,51.91040843214756,
8518,gene,3957390,3958482,1,1092,ilvK,54.02930402930403,
8519,CDS,3957390,3958482,1,1092,ilvK,54.02930402930403,
8520,gene,3958515,3959844,-1,1329,licH,50.48908954100828,
8521,CDS,3958515,3959844,-1,1329,licH,50.48908954100828,
8522,gene,3959840,3960173,-1,333,licA,54.65465465465466,
8523,CDS,3959840,3960173,-1,333,licA,54.65465465465466,
8524,gene,3960191,3961550,-1,1359,licC,48.34437086092716,
8525,CDS,3960191,3961550,-1,1359,licC,48.34437086092716,
8526,gene,3961565,3961874,-1,309,licB,54.69255663430421,
8527,CDS,3961565,3961874,-1,309,licB,54.69255663430421,
8528,gene,3962002,3963928,-1,1926,licR,54.30944963655244,
8529,CDS,3962002,3963928,-1,1926,licR,54.30944963655244,
8530,gene,3964090,3964249,-1,159,yxzF,56.60377358490566,
8531,CDS,3964090,3964249,-1,159,yxzF,56.60377358490566,
8532,gene,3964277,3964868,-1,591,aag,45.68527918781726,
8533,CDS,3964277,3964868,-1,591,aag,45.68527918781726,
8534,gene,3964996,3966640,1,1644,katX,52.433090024330895,
8535,CDS,3964996,3966640,1,1644,katX,52.433090024330895,
8536,gene,3966744,3967947,1,1203,yxlH,51.20532003325021,
8537,CDS,3966744,3967947,1,1203,yxlH,51.20532003325021,
8538,gene,3967943,3968720,-1,777,yxlG,48.13384813384813,
8539,CDS,3967943,3968720,-1,777,yxlG,48.13384813384813,
8540,gene,3968716,3969604,-1,888,yxlF,52.590090090090094,
8541,CDS,3968716,3969604,-1,888,yxlF,52.590090090090094,
8542,gene,3969610,3969799,-1,189,yxlE,56.613756613756614,
8543,CDS,3969610,3969799,-1,189,yxlE,56.613756613756614,
8544,gene,3969795,3970002,-1,207,yxlD,58.454106280193244,
8545,CDS,3969795,3970002,-1,207,yxlD,58.454106280193244,
8546,gene,3969998,3970319,-1,321,yxlC,59.19003115264797,
8547,CDS,3969998,3970319,-1,321,yxlC,59.19003115264797,
8548,gene,3970311,3970848,-1,537,sigY,54.00372439478585,
8549,CDS,3970311,3970848,-1,537,sigY,54.00372439478585,
8550,gene,3971059,3972433,1,1374,yxlA,54.51237263464338,
8551,CDS,3971059,3972433,1,1374,yxlA,54.51237263464338,
8552,gene,3972447,3973278,-1,831,nnrA,43.561973525872446,
8553,CDS,3972447,3973278,-1,831,nnrA,43.561973525872446,
8554,gene,3973363,3975091,-1,1728,cydD,50.57870370370371,
8555,CDS,3973363,3975091,-1,1728,cydD,50.57870370370371,
8556,gene,3975087,3976791,-1,1704,cydC,48.767605633802816,
8557,CDS,3975087,3976791,-1,1704,cydC,48.767605633802816,
8558,gene,3976790,3977807,-1,1017,cydB,52.31071779744346,
8559,CDS,3976790,3977807,-1,1017,cydB,52.31071779744346,
8560,gene,3977790,3979197,-1,1407,cydA,54.93958777540867,
8561,CDS,3977790,3979197,-1,1407,cydA,54.93958777540867,
8562,gene,3979752,3981105,1,1353,cimH,52.40206947524021,
8563,CDS,3979752,3981105,1,1353,cimH,52.40206947524021,
8564,gene,3981226,3982915,1,1689,yxkI,53.93724097098875,
8565,CDS,3981226,3982915,1,1689,yxkI,53.93724097098875,
8566,gene,3982972,3983173,1,201,yxzE,50.74626865671642,
8567,CDS,3982972,3983173,1,201,yxzE,50.74626865671642,
8568,gene,3983186,3984026,-1,840,yxkH,52.261904761904766,
8569,CDS,3983186,3984026,-1,840,yxkH,52.261904761904766,
8570,gene,3984132,3985230,-1,1098,msmX,53.278688524590166,
8571,CDS,3984132,3985230,-1,1098,msmX,53.278688524590166,
8572,gene,3985350,3986244,-1,894,yxkF,57.04697986577181,
8573,CDS,3985350,3986244,-1,894,yxkF,57.04697986577181,
8574,gene,3986427,3987885,1,1458,aldY,51.028806584362144,
8575,CDS,3986427,3987885,1,1458,aldY,51.028806584362144,
8576,gene,3987926,3988763,-1,837,gdnE,59.61768219832736,
8577,CDS,3987926,3988763,-1,837,gdnE,59.61768219832736,
8578,gene,3988839,3988942,-1,103,gdwB,52.42718446601942,
8579,misc_RNA,3988839,3988942,-1,103,gdwB,52.42718446601942,
8580,gene,3989330,3989873,1,543,yxkC,65.19337016574586,
8581,CDS,3989330,3989873,1,543,yxkC,65.19337016574586,
8582,gene,3989947,3990967,-1,1020,galE,51.76470588235295,
8583,CDS,3989947,3990967,-1,1020,galE,51.76470588235295,
8584,gene,3991081,3991588,-1,507,yxkA,55.22682445759369,
8585,CDS,3991081,3991588,-1,507,yxkA,55.22682445759369,
8586,gene,3991717,3992593,1,876,yxjO,52.28310502283106,
8587,CDS,3991717,3992593,1,876,yxjO,52.28310502283106,
8588,gene,3992670,3993144,1,474,yxjN,53.79746835443038,
8589,CDS,3992670,3993144,1,474,yxjN,53.79746835443038,
8590,gene,3993161,3994382,1,1221,yxjM,52.416052416052416,
8591,CDS,3993161,3994382,1,1221,yxjM,52.416052416052416,
8592,gene,3994368,3995025,1,657,yxjL,50.2283105022831,
8593,CDS,3994368,3995025,1,657,yxjL,50.2283105022831,
8594,gene,3995074,3996307,1,1233,pepT,52.7169505271695,
8595,CDS,3995074,3996307,1,1233,pepT,52.7169505271695,
8596,gene,3996828,3997092,1,264,yxjJ,60.22727272727273,
8597,CDS,3996828,3997092,1,264,yxjJ,60.22727272727273,
8598,gene,3997220,3997709,1,489,yxjI,60.32719836400818,
8599,CDS,3997220,3997709,1,489,yxjI,60.32719836400818,
8600,gene,3997774,3997881,1,107,mswI,51.4018691588785,
8601,misc_RNA,3997774,3997881,1,107,mswI,51.4018691588785,
8602,gene,3997963,3999097,1,1134,yxjH,50.08818342151675,
8603,CDS,3997963,3999097,1,1134,yxjH,50.08818342151675,
8604,gene,3999165,3999272,1,107,mswJ,52.336448598130836,
8605,misc_RNA,3999165,3999272,1,107,mswJ,52.336448598130836,
8606,gene,3999349,4000486,1,1137,yxjG,52.06684256816183,
8607,CDS,3999349,4000486,1,1137,yxjG,52.06684256816183,
8608,gene,4000538,4001312,-1,774,yxjF,49.48320413436693,
8609,CDS,4000538,4001312,-1,774,yxjF,49.48320413436693,
8610,gene,4001328,4001979,-1,651,scoB,50.84485407066052,
8611,CDS,4001328,4001979,-1,651,scoB,50.84485407066052,
8612,gene,4001975,4002692,-1,717,scoA,49.37238493723849,
8613,CDS,4001975,4002692,-1,717,scoA,49.37238493723849,
8614,gene,4002715,4004134,-1,1419,yxjC,50.669485553206485,
8615,CDS,4002715,4004134,-1,1419,yxjC,50.669485553206485,
8616,gene,4004287,4005136,-1,849,rlmA,52.65017667844523,
8617,CDS,4004287,4005136,-1,849,rlmA,52.65017667844523,
8618,gene,4005522,4005625,1,103,gswB,71.84466019417476,
8619,misc_RNA,4005522,4005625,1,103,gswB,71.84466019417476,
8620,gene,4005751,4006945,1,1194,nupG,55.27638190954774,
8621,CDS,4005751,4006945,1,1194,nupG,55.27638190954774,
8622,gene,4006986,4007415,-1,429,yxiTc,55.94405594405595,
8623,misc_feature,4006986,4007415,-1,429,yxiTc,55.94405594405595,
8624,gene,4007415,4007658,-1,243,yxiTn,56.79012345679012,
8625,misc_feature,4007415,4007658,-1,243,yxiTn,56.79012345679012,
8626,gene,4007802,4008093,-1,291,yxiS,53.95189003436426,
8627,CDS,4007802,4008093,-1,291,yxiS,53.95189003436426,
8628,gene,4008142,4010203,-1,2061,katE,50.65502183406113,
8629,CDS,4008142,4010203,-1,2061,katE,50.65502183406113,
8630,gene,4010403,4011684,1,1281,citH,48.711943793911004,
8631,CDS,4010403,4011684,1,1281,citH,48.711943793911004,
8632,gene,4011841,4012570,-1,729,bglS,58.29903978052127,
8633,CDS,4011841,4012570,-1,729,bglS,58.29903978052127,
8634,gene,4012865,4013699,-1,834,licT,57.55395683453237,
8635,CDS,4012865,4013699,-1,834,licT,57.55395683453237,
8636,gene,4013794,4014475,-1,681,yxiP,54.77239353891336,
8637,CDS,4013794,4014475,-1,681,yxiP,54.77239353891336,
8638,gene,4014681,4015968,1,1287,yxiO,51.903651903651905,
8639,CDS,4014681,4015968,1,1287,yxiO,51.903651903651905,
8640,gene,4015986,4017426,-1,1440,deaD,54.23611111111111,
8641,CDS,4015986,4017426,-1,1440,deaD,54.23611111111111,
8642,gene,4017507,4018656,-1,1149,yxiM,49.69538729329852,
8643,CDS,4017507,4018656,-1,1149,yxiM,49.69538729329852,
8644,gene,4018785,4018974,-1,189,yxzI,57.67195767195767,
8645,misc_feature,4018785,4018974,-1,189,yxzI,57.67195767195767,
8646,gene,4019004,4019136,-1,132,yxzJ,68.93939393939394,
8647,CDS,4019004,4019136,-1,132,yxzJ,68.93939393939394,
8648,gene,4019147,4019609,-1,462,yxiK,58.22510822510822,
8649,CDS,4019147,4019609,-1,462,yxiK,58.22510822510822,
8650,gene,4019624,4019921,-1,297,yxiJ,57.91245791245792,
8651,CDS,4019624,4019921,-1,297,yxiJ,57.91245791245792,
8652,gene,4019948,4020437,-1,489,yxiI,57.259713701431494,
8653,CDS,4019948,4020437,-1,489,yxiI,57.259713701431494,
8654,gene,4020454,4020907,-1,453,yxzG,56.73289183222958,
8655,CDS,4020454,4020907,-1,453,yxzG,56.73289183222958,
8656,gene,4020976,4021306,-1,330,yxiH,60.303030303030305,
8657,CDS,4020976,4021306,-1,330,yxiH,60.303030303030305,
8658,gene,4021428,4021845,-1,417,yxiG,67.14628297362111,
8659,CDS,4021428,4021845,-1,417,yxiG,67.14628297362111,
8660,gene,4021895,4022264,-1,369,yxzC,66.39566395663957,
8661,CDS,4021895,4022264,-1,369,yxzC,66.39566395663957,
8662,gene,4022257,4022728,-1,471,yxiF,58.81104033970276,
8663,CDS,4022257,4022728,-1,471,yxiF,58.81104033970276,
8664,gene,4023053,4023482,-1,429,wapI,70.62937062937063,
8665,CDS,4023053,4023482,-1,429,wapI,70.62937062937063,
8666,gene,4023543,4030548,-1,7005,wapA,57.230549607423264,
8667,CDS,4023543,4030548,-1,7005,wapA,57.230549607423264,cell wall-associated tRNA nuclease precursor; intercellular growth inhibitor
8668,gene,4030709,4031645,-1,936,yxxF,54.48717948717948,
8669,CDS,4030709,4031645,-1,936,yxxF,54.48717948717948,
8670,gene,4031796,4032243,-1,447,yxiE,54.138702460850105,
8671,CDS,4031796,4032243,-1,447,yxiE,54.138702460850105,
8672,gene,4032345,4033755,-1,1410,bglH,54.04255319148936,
8673,CDS,4032345,4033755,-1,1410,bglH,54.04255319148936,
8674,gene,4033777,4035607,-1,1830,bglP,49.56284153005465,
8675,CDS,4033777,4035607,-1,1830,bglP,49.56284153005465,
8676,gene,4035989,4036298,-1,309,yxxE,67.96116504854369,
8677,CDS,4035989,4036298,-1,309,yxxE,67.96116504854369,
8678,gene,4036343,4036787,-1,444,rtbE,74.54954954954955,
8679,CDS,4036343,4036787,-1,444,rtbE,74.54954954954955,
8680,gene,4036783,4038493,-1,1710,rtbD,60.994152046783626,
8681,CDS,4036783,4038493,-1,1710,rtbD,60.994152046783626,
8682,gene,4038512,4038782,-1,270,yxiC,56.2962962962963,
8683,CDS,4038512,4038782,-1,270,yxiC,56.2962962962963,
8684,gene,4038793,4039159,-1,366,yxiB,58.46994535519126,
8685,CDS,4038793,4039159,-1,366,yxiB,58.46994535519126,
8686,gene,4039465,4040875,-1,1410,abnB,51.48936170212765,
8687,CDS,4039465,4040875,-1,1410,abnB,51.48936170212765,
8688,gene,4041008,4041173,-1,165,yxzL,58.78787878787879,
8689,CDS,4041008,4041173,-1,165,yxzL,58.78787878787879,
8690,gene,4041491,4041938,1,447,hutP,48.769574944071586,
8691,CDS,4041491,4041938,1,447,hutP,48.769574944071586,
8692,gene,4042050,4043577,1,1527,hutH,50.491159135559926,
8693,CDS,4042050,4043577,1,1527,hutH,50.491159135559926,
8694,gene,4043573,4045232,1,1659,hutU,47.739602169981914,
8695,CDS,4043573,4045232,1,1659,hutU,47.739602169981914,
8696,gene,4045244,4046510,1,1266,hutI,51.73775671406003,
8697,CDS,4045244,4046510,1,1266,hutI,51.73775671406003,
8698,gene,4046502,4047462,1,960,hutG,52.708333333333336,
8699,CDS,4046502,4047462,1,960,hutG,52.708333333333336,
8700,gene,4047537,4048965,1,1428,hutM,55.25210084033614,
8701,CDS,4047537,4048965,1,1428,hutM,55.25210084033614,
8702,gene,4049008,4050310,-1,1302,pdp,49.53917050691244,
8703,CDS,4049008,4050310,-1,1302,pdp,49.53917050691244,
8704,gene,4050339,4051521,-1,1182,nupC,56.76818950930627,
8705,CDS,4050339,4051521,-1,1182,nupC,56.76818950930627,
8706,gene,4051601,4052273,-1,672,deoC,53.57142857142857,
8707,CDS,4051601,4052273,-1,672,deoC,53.57142857142857,
8708,gene,4052378,4053320,-1,942,deoR,51.167728237791934,
8709,CDS,4052378,4053320,-1,942,deoR,51.167728237791934,
8710,gene,4053453,4054281,-1,828,yxxB,50.36231884057971,
8711,CDS,4053453,4054281,-1,828,yxxB,50.36231884057971,
8712,gene,4054353,4055466,-1,1113,yxeR,49.32614555256065,
8713,CDS,4054353,4055466,-1,1113,yxeR,49.32614555256065,
8714,gene,4055535,4056873,-1,1338,yxeQ,49.40209267563528,
8715,CDS,4055535,4056873,-1,1338,yxeQ,49.40209267563528,
8716,gene,4056869,4058012,-1,1143,sndB,49.69378827646544,
8717,CDS,4056869,4058012,-1,1143,sndB,49.69378827646544,
8718,gene,4058028,4058778,-1,750,yxeO,52.53333333333333,
8719,CDS,4058028,4058778,-1,750,yxeO,52.53333333333333,
8720,gene,4058790,4059465,-1,675,yxeN,54.074074074074076,
8721,CDS,4058790,4059465,-1,675,yxeN,54.074074074074076,
8722,gene,4059487,4060282,-1,795,yxeM,56.10062893081761,
8723,CDS,4059487,4060282,-1,795,yxeM,56.10062893081761,
8724,gene,4060306,4060804,-1,498,snaB,51.40562248995983,
8725,CDS,4060306,4060804,-1,498,snaB,51.40562248995983,
8726,gene,4060817,4062143,-1,1326,yxeK,52.26244343891403,
8727,CDS,4060817,4062143,-1,1326,yxeK,52.26244343891403,
8728,gene,4062328,4062556,-1,228,yxeJ,62.71929824561403,
8729,CDS,4062328,4062556,-1,228,yxeJ,62.71929824561403,
8730,gene,4062542,4063529,-1,987,yxeI,56.02836879432624,
8731,CDS,4062542,4063529,-1,987,yxeI,56.02836879432624,
8732,gene,4063683,4064496,-1,813,hadM,55.104551045510455,
8733,CDS,4063683,4064496,-1,813,hadM,55.104551045510455,
8734,gene,4064535,4065093,-1,558,yxeG,57.168458781362006,
8735,CDS,4064535,4065093,-1,558,yxeG,57.168458781362006,
8736,gene,4065073,4065508,-1,435,yxeF,52.87356321839081,
8737,CDS,4065073,4065508,-1,435,yxeF,52.87356321839081,
8738,gene,4065596,4065962,1,366,cotNE,51.36612021857923,
8739,CDS,4065596,4065962,1,366,cotNE,51.36612021857923,
8740,gene,4066209,4066563,1,354,yxeD,52.824858757062145,
8741,CDS,4066209,4066563,1,354,yxeD,52.824858757062145,
8742,gene,4066606,4067005,-1,399,yxeC,57.89473684210527,
8743,CDS,4066606,4067005,-1,399,yxeC,57.89473684210527,
8744,gene,4067182,4068148,1,966,frxB,56.83229813664597,
8745,CDS,4067182,4068148,1,966,frxB,56.83229813664597,
8746,gene,4068188,4068536,-1,348,yxeA,56.32183908045977,
8747,CDS,4068188,4068536,-1,348,yxeA,56.32183908045977,
8748,gene,4068549,4070418,-1,1869,tpeM,55.912252541466025,
8749,CDS,4068549,4070418,-1,1869,tpeM,55.912252541466025,
8750,gene,4070392,4071166,-1,774,tpeL,51.93798449612403,
8751,CDS,4070392,4071166,-1,774,tpeL,51.93798449612403,
8752,gene,4071309,4072287,-1,978,tpeK,53.88548057259713,
8753,CDS,4071309,4072287,-1,978,tpeK,53.88548057259713,
8754,gene,4072283,4072973,-1,690,tpeJ,52.60869565217391,
8755,CDS,4072283,4072973,-1,690,tpeJ,52.60869565217391,
8756,gene,4073080,4073953,-1,873,iolJ,46.391752577319586,
8757,CDS,4073080,4073953,-1,873,iolJ,46.391752577319586,
8758,gene,4073973,4074810,-1,837,iolI,57.34767025089605,
8759,CDS,4073973,4074810,-1,837,iolI,57.34767025089605,
8760,gene,4074895,4075765,-1,870,iolH,56.20689655172414,
8761,CDS,4074895,4075765,-1,870,iolH,56.20689655172414,
8762,gene,4075784,4076819,-1,1035,iolG,54.685990338164245,
8763,CDS,4075784,4076819,-1,1035,iolG,54.685990338164245,
8764,gene,4076841,4078158,-1,1317,iolF,50.87319665907365,
8765,CDS,4076841,4078158,-1,1317,iolF,50.87319665907365,
8766,gene,4078172,4079066,-1,894,iolE,51.67785234899329,
8767,CDS,4078172,4079066,-1,894,iolE,51.67785234899329,
8768,gene,4079082,4080996,-1,1914,iolD,51.35841170323929,
8769,CDS,4079082,4080996,-1,1914,iolD,51.35841170323929,
8770,gene,4081028,4082006,-1,978,iolC,52.24948875255624,
8771,CDS,4081028,4082006,-1,978,iolC,52.24948875255624,
8772,gene,4082029,4082845,-1,816,iolB,54.53431372549019,
8773,CDS,4082029,4082845,-1,816,iolB,54.53431372549019,
8774,gene,4082919,4084383,-1,1464,iolA,52.322404371584696,
8775,CDS,4082919,4084383,-1,1464,iolA,52.322404371584696,
8776,gene,4084798,4085554,1,756,iolR,58.06878306878307,
8777,CDS,4084798,4085554,1,756,iolR,58.06878306878307,
8778,gene,4085607,4086540,1,933,iolS,57.449088960342976,
8779,CDS,4085607,4086540,1,933,iolS,57.449088960342976,
8780,gene,4086801,4087452,1,651,yxcE,56.83563748079877,
8781,CDS,4086801,4087452,1,651,yxcE,56.83563748079877,
8782,gene,4087455,4087764,1,309,yxcD,61.165048543689316,
8783,CDS,4087455,4087764,1,309,yxcD,61.165048543689316,
8784,gene,4088001,4089387,1,1386,csbC,49.63924963924964,
8785,CDS,4088001,4089387,1,1386,csbC,49.63924963924964,
8786,gene,4089428,4091309,-1,1881,htpG,55.76820839978735,
8787,CDS,4089428,4091309,-1,1881,htpG,55.76820839978735,
8788,gene,4091476,4091728,-1,252,yxcA,58.333333333333336,
8789,CDS,4091476,4091728,-1,252,yxcA,58.333333333333336,
8790,gene,4091844,4092666,1,822,yxbG,49.27007299270073,
8791,CDS,4091844,4092666,1,822,yxbG,49.27007299270073,
8792,gene,4092694,4093837,-1,1143,yxbF,54.06824146981627,
8793,CDS,4092694,4093837,-1,1143,yxbF,54.06824146981627,
8794,gene,4093979,4095317,1,1338,aldX,51.79372197309418,
8795,CDS,4093979,4095317,1,1338,aldX,51.79372197309418,
8796,gene,4095355,4095835,-1,480,yxbD,60.83333333333333,
8797,CDS,4095355,4095835,-1,480,yxbD,60.83333333333333,
8798,gene,4095914,4096907,-1,993,yxbC,58.81168177240684,
8799,CDS,4095914,4096907,-1,993,yxbC,58.81168177240684,
8800,gene,4096996,4097409,1,413,srlX,58.111380145278446,
8801,misc_RNA,4096996,4097409,1,413,srlX,58.111380145278446,
8802,gene,4097415,4098150,1,735,yxbB,59.183673469387756,
8803,CDS,4097415,4098150,1,735,yxbB,59.183673469387756,
8804,gene,4098149,4098419,1,270,yxbA,65.55555555555556,
8805,CDS,4098149,4098419,1,270,yxbA,65.55555555555556,
8806,gene,4098422,4098905,1,483,yxnB,64.80331262939958,
8807,CDS,4098422,4098905,1,483,yxnB,64.80331262939958,
8808,gene,4098925,4101169,1,2244,asnH,59.62566844919787,
8809,CDS,4098925,4101169,1,2244,asnH,59.62566844919787,
8810,gene,4101165,4102365,1,1200,yxaM,62.74999999999999,
8811,CDS,4101165,4102365,1,1200,yxaM,62.74999999999999,
8812,gene,4102428,4103661,-1,1233,yxaL,51.58150851581509,
8813,CDS,4102428,4103661,-1,1233,yxaL,51.58150851581509,
8814,gene,4103761,4104187,-1,426,yxaJ,53.051643192488264,
8815,CDS,4103761,4104187,-1,426,yxaJ,53.051643192488264,
8816,gene,4104443,4104899,1,456,yxaI,61.18421052631579,
8817,CDS,4104443,4104899,1,456,yxaI,61.18421052631579,
8818,gene,4104928,4106137,-1,1209,yxaH,56.82382133995038,
8819,CDS,4104928,4106137,-1,1209,yxaH,56.82382133995038,
8820,gene,4106244,4107258,-1,1014,qdoI,52.85996055226825,
8821,CDS,4106244,4107258,-1,1014,qdoI,52.85996055226825,
8822,gene,4107351,4107927,-1,576,qdoR,56.94444444444444,
8823,CDS,4107351,4107927,-1,576,qdoR,56.94444444444444,
8824,gene,4108057,4109128,1,1071,yxnA,47.05882352941176,
8825,CDS,4108057,4109128,1,1071,yxnA,47.05882352941176,
8826,gene,4109184,4109616,-1,432,yxaD,58.79629629629629,
8827,CDS,4109184,4109616,-1,432,yxaD,58.79629629629629,
8828,gene,4109842,4110247,1,405,yxzK,57.03703703703704,
8829,CDS,4109842,4110247,1,405,yxzK,57.03703703703704,
8830,gene,4110216,4110909,1,693,yxaC,50.93795093795094,
8831,CDS,4110216,4110909,1,693,yxaC,50.93795093795094,
8832,gene,4110948,4111980,-1,1032,yxaB,58.04263565891473,
8833,CDS,4110948,4111980,-1,1032,yxaB,58.04263565891473,
8834,gene,4112072,4113221,-1,1149,glxK,47.4325500435161,
8835,CDS,4112072,4113221,-1,1149,glxK,47.4325500435161,
8836,gene,4113416,4114148,1,732,gntR,59.01639344262295,
8837,CDS,4113416,4114148,1,732,gntR,59.01639344262295,
8838,gene,4114140,4115682,1,1542,gntK,51.36186770428015,
8839,CDS,4114140,4115682,1,1542,gntK,51.36186770428015,
8840,gene,4115710,4117057,1,1347,gntP,53.08092056421678,
8841,CDS,4115710,4117057,1,1347,gntP,53.08092056421678,
8842,gene,4117079,4118486,1,1407,gntZ,52.38095238095239,
8843,CDS,4117079,4118486,1,1407,gntZ,52.38095238095239,
8844,gene,4118949,4119513,1,564,ahpC,56.91489361702128,
8845,CDS,4118949,4119513,1,564,ahpC,56.91489361702128,
8846,gene,4119526,4121056,1,1530,ahpF,52.09150326797386,
8847,CDS,4119526,4121056,1,1530,ahpF,52.09150326797386,
8848,gene,4121165,4122605,-1,1440,bglA,54.72222222222223,
8849,CDS,4121165,4122605,-1,1440,bglA,54.72222222222223,
8850,gene,4122618,4122849,-1,231,ptsJ,54.54545454545454,
8851,CDS,4122618,4122849,-1,231,ptsJ,54.54545454545454,
8852,gene,4123192,4123903,1,711,yydK,56.118143459915615,
8853,CDS,4123192,4123903,1,711,yydK,56.118143459915615,
8854,gene,4123930,4124089,1,159,yyzN,66.66666666666666,
8855,CDS,4123930,4124089,1,159,yyzN,66.66666666666666,
8856,gene,4124219,4124942,-1,723,liaM,70.40110650069157,
8857,CDS,4124219,4124942,-1,723,liaM,70.40110650069157,
8858,gene,4124962,4125592,-1,630,liaL,70.15873015873015,
8859,CDS,4124962,4125592,-1,630,liaL,70.15873015873015,
8860,gene,4125741,4126500,-1,759,liaK,73.12252964426878,
8861,CDS,4125741,4126500,-1,759,liaK,73.12252964426878,
8862,gene,4126480,4127440,-1,960,liaE,69.58333333333333,
8863,CDS,4126480,4127440,-1,960,liaE,69.58333333333333,
8864,gene,4127497,4127647,-1,150,liaD,70.0,
8865,CDS,4127497,4127647,-1,150,liaD,70.0,
8866,gene,4128118,4130044,1,1926,fbp,54.932502596054,
8867,CDS,4128118,4130044,1,1926,fbp,54.932502596054,
8868,gene,4130577,4132338,-1,1761,yydD,73.59454855195912,
8869,CDS,4130577,4132338,-1,1761,yydD,73.59454855195912,
8870,gene,4132337,4132736,-1,399,yydC,74.18546365914787,
8871,CDS,4132337,4132736,-1,399,yydC,74.18546365914787,
8872,gene,4132728,4134174,-1,1446,yydB,71.23098201936376,
8873,CDS,4132728,4134174,-1,1446,yydB,71.23098201936376,
8874,gene,4134435,4134915,-1,480,rlmH,54.79166666666667,
8875,CDS,4134435,4134915,-1,480,rlmH,54.79166666666667,
8876,gene,4134995,4135166,-1,171,yyzF,56.72514619883041,
8877,CDS,4134995,4135166,-1,171,yyzF,56.72514619883041,
8878,gene,4135350,4135764,1,414,yycS,58.69565217391305,
8879,CDS,4135350,4135764,1,414,yycS,58.69565217391305,
8880,gene,4135797,4137024,-1,1227,yycR,46.536267318663405,
8881,CDS,4135797,4137024,-1,1227,yycR,46.536267318663405,
8882,gene,4137086,4137257,-1,171,yyzG,60.23391812865497,
8883,CDS,4137086,4137257,-1,171,yyzG,60.23391812865497,
8884,gene,4137361,4137610,-1,249,yycQ,60.6425702811245,
8885,CDS,4137361,4137610,-1,249,yycQ,60.6425702811245,
8886,gene,4137625,4138789,-1,1164,yycP,52.57731958762887,
8887,CDS,4137625,4138789,-1,1164,yycP,52.57731958762887,
8888,gene,4138799,4139537,-1,738,yycO,50.271002710027105,
8889,CDS,4138799,4139537,-1,738,yycO,50.271002710027105,
8890,gene,4139678,4140149,-1,471,yycN,52.653927813163484,
8891,CDS,4139678,4140149,-1,471,yycN,52.653927813163484,
8892,gene,4140259,4141357,1,1098,rapG,58.19672131147541,
8893,CDS,4140259,4141357,1,1098,rapG,58.19672131147541,
8894,gene,4141357,4141474,1,117,phrG,56.41025641025641,
8895,CDS,4141357,4141474,1,117,phrG,56.41025641025641,
8896,gene,4141710,4142601,-1,891,argI,50.16835016835017,
8897,CDS,4141710,4142601,-1,891,argI,50.16835016835017,
8898,gene,4142674,4144078,-1,1404,rocE,52.27920227920227,
8899,CDS,4142674,4144078,-1,1404,rocE,52.27920227920227,
8900,gene,4144300,4145506,-1,1206,rocD,50.91210613598673,
8901,CDS,4144300,4145506,-1,1206,rocD,50.91210613598673,
8902,gene,4145746,4147132,1,1386,rocR,52.95815295815296,
8903,CDS,4145746,4147132,1,1386,rocR,52.95815295815296,
8904,gene,4147113,4147302,-1,189,yyzO,52.38095238095239,
8905,misc_feature,4147113,4147302,-1,189,yyzO,52.38095238095239,
8906,gene,4147418,4147547,-1,129,BSU_40358,61.240310077519375,
8907,CDS,4147418,4147547,-1,129,BSU_40358,61.240310077519375,
8908,gene,4147566,4148769,-1,1203,htrC,51.78719866999168,
8909,CDS,4147566,4148769,-1,1203,htrC,51.78719866999168,
8910,gene,4148850,4149645,-1,795,walJ,51.57232704402516,
8911,CDS,4148850,4149645,-1,795,walJ,51.57232704402516,
8912,gene,4149666,4150509,-1,843,walI,60.26097271648872,
8913,CDS,4149666,4150509,-1,843,walI,60.26097271648872,
8914,gene,4150495,4151863,-1,1368,walH,58.040935672514614,
8915,CDS,4150495,4151863,-1,1368,walH,58.040935672514614,
8916,gene,4151852,4153688,-1,1836,walK,56.42701525054466,
8917,CDS,4151852,4153688,-1,1836,walK,56.42701525054466,
8918,gene,4153695,4154403,-1,708,walR,54.94350282485876,
8919,CDS,4153695,4154403,-1,708,walR,54.94350282485876,
8920,gene,4154786,4154859,-1,73,trnY-Phe,41.0958904109589,
8921,tRNA,4154786,4154859,-1,73,trnY-Phe,41.0958904109589,
8922,gene,4154894,4154971,-1,77,trnY-Asp,36.36363636363637,
8923,tRNA,4154894,4154971,-1,77,trnY-Asp,36.36363636363637,
8924,gene,4155052,4155124,-1,72,trnY-Glu,38.88888888888889,
8925,tRNA,4155052,4155124,-1,72,trnY-Glu,38.88888888888889,
8926,gene,4155133,4155209,-1,76,trnY-Lys,51.31578947368421,
8927,tRNA,4155133,4155209,-1,76,trnY-Lys,51.31578947368421,
8928,gene,4155432,4156725,-1,1293,purA,52.82289249806651,
8929,CDS,4155432,4156725,-1,1293,purA,52.82289249806651,
8930,gene,4156930,4157350,-1,420,yycE,51.66666666666667,
8931,CDS,4156930,4157350,-1,420,yycE,51.66666666666667,
8932,gene,4157470,4158835,-1,1365,dnaC,51.64835164835166,
8933,CDS,4157470,4158835,-1,1365,dnaC,51.64835164835166,
8934,gene,4159004,4159205,1,201,yycD,59.70149253731343,
8935,CDS,4159004,4159205,1,201,yycD,59.70149253731343,
8936,gene,4159252,4159456,-1,204,yyzB,59.31372549019608,
8937,CDS,4159252,4159456,-1,204,yyzB,59.31372549019608,
8938,gene,4159576,4159717,1,141,yycC,56.02836879432624,
8939,CDS,4159576,4159717,1,141,yycC,56.02836879432624,
8940,gene,4159789,4160998,1,1209,yycB,50.28949545078577,
8941,CDS,4159789,4160998,1,1209,yycB,50.28949545078577,
8942,gene,4161102,4163160,1,2058,yycA,50.77745383867833,
8943,CDS,4161102,4163160,1,2058,yycA,50.77745383867833,
8944,gene,4163196,4163646,-1,450,rplI,57.77777777777777,
8945,CDS,4163196,4163646,-1,450,rplI,57.77777777777777,
8946,gene,4163642,4165622,-1,1980,gdpP,55.20202020202019,
8947,CDS,4163642,4165622,-1,1980,gdpP,55.20202020202019,
8948,gene,4165658,4166588,-1,930,yybS,59.46236559139785,
8949,CDS,4165658,4166588,-1,930,yybS,59.46236559139785,
8950,gene,4166814,4166964,-1,150,yyzH,66.0,
8951,CDS,4166814,4166964,-1,150,yyzH,66.0,
8952,gene,4167109,4167592,1,483,cotF,56.7287784679089,
8953,CDS,4167109,4167592,1,483,cotF,56.7287784679089,
8954,gene,4167621,4167999,-1,378,hypR,54.761904761904766,
8955,CDS,4167621,4167999,-1,378,hypR,54.761904761904766,
8956,gene,4168203,4169133,1,930,ppaC,57.096774193548384,
8957,CDS,4168203,4169133,1,930,ppaC,57.096774193548384,
8958,gene,4169165,4169612,-1,447,yybP,52.79642058165548,
8959,CDS,4169165,4169612,-1,447,yybP,52.79642058165548,
8960,gene,4169801,4169919,-1,118,mswM,54.23728813559322,
8961,misc_RNA,4169801,4169919,-1,118,mswM,54.23728813559322,
8962,gene,4170044,4171352,1,1308,yybO,53.74617737003058,
8963,CDS,4170044,4171352,1,1308,yybO,53.74617737003058,
8964,gene,4171395,4171635,-1,240,yyzI,55.833333333333336,
8965,misc_feature,4171395,4171635,-1,240,yyzI,55.833333333333336,
8966,gene,4171624,4171789,-1,165,yyzJ,60.60606060606061,
8967,misc_feature,4171624,4171789,-1,165,yyzJ,60.60606060606061,
8968,gene,4171800,4171986,-1,186,BSU_40576,54.83870967741935,
8969,CDS,4171800,4171986,-1,186,BSU_40576,54.83870967741935,
8970,gene,4172258,4172405,-1,147,yyzK,63.94557823129252,
8971,misc_feature,4172258,4172405,-1,147,yyzK,63.94557823129252,
8972,gene,4172386,4172536,-1,150,yyzL,65.33333333333333,
8973,misc_feature,4172386,4172536,-1,150,yyzL,65.33333333333333,
8974,gene,4173113,4173551,1,438,yybN,65.06849315068493,
8975,CDS,4173113,4173551,1,438,yybN,65.06849315068493,
8976,gene,4173664,4174420,1,756,yybM,71.95767195767195,
8977,CDS,4173664,4174420,1,756,yybM,71.95767195767195,
8978,gene,4174409,4175120,1,711,yybL,73.9803094233474,
8979,CDS,4174409,4175120,1,711,yybL,73.9803094233474,
8980,gene,4175116,4175872,1,756,yybK,73.14814814814815,
8981,CDS,4175116,4175872,1,756,yybK,73.14814814814815,
8982,gene,4175868,4176525,1,657,yybJ,70.62404870624049,
8983,CDS,4175868,4176525,1,657,yybJ,70.62404870624049,
8984,gene,4176899,4177688,-1,789,ictI,56.27376425855514,
8985,CDS,4176899,4177688,-1,789,ictI,56.27376425855514,
8986,gene,4177755,4178145,-1,390,yybH,58.97435897435898,
8987,CDS,4177755,4178145,-1,390,yybH,58.97435897435898,
8988,gene,4178290,4179130,1,840,yybG,51.3095238095238,
8989,CDS,4178290,4179130,1,840,yybG,51.3095238095238,
8990,gene,4179162,4180377,-1,1215,yybF,54.15637860082304,
8991,CDS,4179162,4180377,-1,1215,yybF,54.15637860082304,
8992,gene,4180563,4181442,1,879,yybE,53.242320819112635,
8993,CDS,4180563,4181442,1,879,yybE,53.242320819112635,
8994,gene,4181455,4181899,1,444,yybD,54.054054054054056,
8995,CDS,4181455,4181899,1,444,yybD,54.054054054054056,
8996,gene,4181981,4182461,1,480,yybC,57.70833333333333,
8997,CDS,4181981,4182461,1,480,yybC,57.70833333333333,
8998,gene,4182635,4183298,-1,663,yybB,58.82352941176471,
8999,CDS,4182635,4183298,-1,663,yybB,58.82352941176471,
9000,gene,4183444,4183897,-1,453,yybA,60.04415011037527,
9001,CDS,4183444,4183897,-1,453,yybA,60.04415011037527,
9002,gene,4184016,4184463,1,447,yyaT,57.494407158836694,
9003,CDS,4184016,4184463,1,447,yyaT,57.494407158836694,
9004,gene,4184459,4185065,1,606,yyaS,61.88118811881188,
9005,CDS,4184459,4185065,1,606,yyaS,61.88118811881188,
9006,gene,4185159,4185681,-1,522,yyaR,65.90038314176245,
9007,CDS,4185159,4185681,-1,522,yyaR,65.90038314176245,
9008,gene,4186091,4186448,1,357,yyaQ,63.305322128851536,
9009,CDS,4186091,4186448,1,357,yyaQ,63.305322128851536,
9010,gene,4186607,4187174,1,567,yyaP,69.31216931216932,
9011,CDS,4186607,4187174,1,567,yyaP,69.31216931216932,
9012,gene,4187680,4189057,-1,1377,tetB,60.05809731299927,
9013,CDS,4187680,4189057,-1,1377,tetB,60.05809731299927,
9014,gene,4189090,4189153,-1,63,tetL,65.07936507936508,
9015,CDS,4189090,4189153,-1,63,tetL,65.07936507936508,
9016,gene,4189405,4189645,1,240,yyaO,57.08333333333333,
9017,CDS,4189405,4189645,1,240,yyaO,57.08333333333333,
9018,gene,4189795,4190212,1,417,yyaN,66.66666666666666,
9019,CDS,4189795,4190212,1,417,yyaN,66.66666666666666,
9020,gene,4190208,4191126,1,918,yyaM,63.61655773420479,
9021,CDS,4190208,4191126,1,918,yyaM,63.61655773420479,
9022,gene,4191197,4193267,1,2070,yyaL,52.65700483091788,
9023,CDS,4191197,4193267,1,2070,yyaL,52.65700483091788,
9024,gene,4193263,4194163,-1,900,yyaK,59.22222222222222,
9025,CDS,4193263,4194163,-1,900,yyaK,59.22222222222222,
9026,gene,4194388,4195744,1,1356,yyaJ,54.64601769911505,
9027,CDS,4194388,4195744,1,1356,yyaJ,54.64601769911505,
9028,gene,4195777,4196332,-1,555,maa,54.054054054054056,
9029,CDS,4195777,4196332,-1,555,maa,54.054054054054056,
9030,gene,4196349,4196730,-1,381,yyaH,58.00524934383202,
9031,CDS,4196349,4196730,-1,381,yyaH,58.00524934383202,
9032,gene,4196785,4197721,-1,936,ccpB,56.623931623931625,
9033,CDS,4196785,4197721,-1,936,ccpB,56.623931623931625,
9034,gene,4197779,4198538,-1,759,exoA,57.180500658761524,
9035,CDS,4197779,4198538,-1,759,exoA,57.180500658761524,
9036,gene,4198602,4198842,-1,240,rpsR,55.41666666666667,
9037,CDS,4198602,4198842,-1,240,rpsR,55.41666666666667,
9038,gene,4198885,4199404,-1,519,ssbA,53.179190751445084,
9039,CDS,4198885,4199404,-1,519,ssbA,53.179190751445084,
9040,gene,4199444,4199732,-1,288,rpsF,57.986111111111114,
9041,CDS,4199444,4199732,-1,288,rpsF,57.986111111111114,
9042,gene,4199842,4200943,-1,1101,engD,54.31425976385105,
9043,CDS,4199842,4200943,-1,1101,engD,54.31425976385105,
9044,gene,4201069,4203073,-1,2004,yyaE,54.041916167664674,
9045,CDS,4201069,4203073,-1,2004,yyaE,54.041916167664674,
9046,gene,4203123,4203330,-1,207,yyzM,60.38647342995169,
9047,CDS,4203123,4203330,-1,207,yyzM,60.38647342995169,
9048,gene,4203423,4204440,-1,1017,yyaD,56.44051130776795,
9049,CDS,4203423,4204440,-1,1017,yyaD,56.44051130776795,
9050,gene,4204899,4205517,1,618,sprC,55.98705501618123,
9051,CDS,4204899,4205517,1,618,sprC,55.98705501618123,
9052,gene,4205555,4206404,-1,849,parB,59.246171967020025,
9053,CDS,4205555,4206404,-1,849,parB,59.246171967020025,
9054,gene,4206396,4207158,-1,762,parA,57.21784776902887,
9055,CDS,4206396,4207158,-1,762,parA,57.21784776902887,
9056,gene,4207405,4207846,1,441,yyaB,63.49206349206349,
9057,CDS,4207405,4207846,1,441,yyaB,63.49206349206349,
9058,gene,4207896,4208748,-1,852,nocA,54.81220657276995,
9059,CDS,4207896,4208748,-1,852,nocA,54.81220657276995,
9060,gene,4208869,4209589,-1,720,rsmG,59.30555555555556,
9061,CDS,4208869,4209589,-1,720,rsmG,59.30555555555556,
9062,gene,4209602,4211489,-1,1887,trmF,53.84207737148914,
9063,CDS,4209602,4211489,-1,1887,trmF,53.84207737148914,
9064,gene,4211509,4212889,-1,1380,mnmE,54.20289855072464,
9065,CDS,4211509,4212889,-1,1380,mnmE,54.20289855072464,
9066,gene,4213199,4213826,-1,627,jag,58.0542264752791,
9067,CDS,4213199,4213826,-1,627,jag,58.0542264752791,
9068,gene,4213822,4214608,-1,786,oxaAA,59.28753180661578,
9069,CDS,4213822,4214608,-1,786,oxaAA,59.28753180661578,
9070,gene,4214752,4215103,-1,351,rnpA,60.68376068376068,
9071,CDS,4214752,4215103,-1,351,rnpA,60.68376068376068,
9072,gene,4215254,4215389,-1,135,rpmH,56.2962962962963,
9073,CDS,4215254,4215389,-1,135,rpmH,56.2962962962963,
